360°旋转的客家剧场，全球第一座「土楼中的酒店」	户外活动	1224
入住枫丹白露古典别宫，畅游塘栖古镇	户外活动	1590
法式浪漫，离你最近的法国小镇	户外活动	1716
在最美月河吃大餐，住原汁原味的私房客栈	户外活动	1868
奉贤亲子游！魔都不一样的田园风光	户外活动	2314
十个吃货九个爱的宁波海鲜	户外活动	3036
走进<爸爸去哪儿拍摄地灵水举人村  古村爨底下  品尝美食	户外活动	None
<红叶季秋高气爽 奔跑吸氧 我在松坪沟等你	户外活动	None
<四川宝兴-达瓦更扎2日游日出云海星空零徒步	户外活动	None
零基础相约高尔夫 ‖ 超值体验 你值得拥有	运动健身	None
【限量优惠】DIY芝士流心蛋挞，再品尝日本10款好吃到哭的蛋卷	DIY手作	None
【银杏之秋】11.20 探千年古村：指南村，赏深秋最美色	户外活动	None
零基础学摄影，你只需要8个晚上	文艺生活	None
12月4日 来约会吧单身交友会 | 找人一起过圣诞	派对聚会	None
走进油画的世界~~~色彩 | 圆你的绘画梦	文艺生活	None
爱音乐爱运动爱笑，尤克里里给你带来满满元气！	文艺生活	None
揭开咖啡的小资外衣｜在家做好喝的意式咖啡	文艺生活	None
【天然氧吧】在最美的深秋，徒步红峡谷悬空木栈道！	户外活动	None
周六：相遇北方小乌镇-赏古北水镇夜景-登司马台长城	户外活动	None
【限量】【买一赠一】超幼稚！？－村上隆作品收藏展	文艺生活	None
享受悠闲假日时光――零基础装饰画专场活动	文艺生活	None
北极村 北红村 邂逅最美极光 得瑟在东北大地【全国召集】	户外活动	None
【每周六、日】 中国银杏第一乡―海洋乡赏百万遍野银杏，兴安古镇看千年水街	户外活动	None
浪漫满屋，手绘插画	文艺生活	None
蒙娜丽莎给自己的情书	文艺生活	None
【转角的芦苇】绿云自动 清风徐来 芦苇飘扬，东白山徒步见风车芦苇荡	户外活动	None
【送你一把琴 弹会一首歌】你就是海滩下的那乌克丽丽	文艺生活	None
身无彩凤双飞翼，谁知我心”一点通	沙龙学堂	None
自画像绘画零基础体验-工作之外的生活应该是这样的	沙龙学堂	None
一咖啡||一电影，光棍节我们一起看电影	派对聚会	None
【干花首饰设计课】设计一款专属于你的花朵 首饰	DIY手作	None
【英式贵族运动】扬鞭起航，策马奔腾	运动健身	None
【特价128元】寻觅大明山秋色，体验悬空栈道	户外活动	None
茶艺体验课 | 通过茶道来修炼心性，体会自然，感悟生活	茶会雅集	None
光棍节，壹蜂放了个单身趴大招，你敢接吗？	派对聚会	None
单身k歌，以歌会友	派对聚会	None
【金秋之旅】广西海洋乡银杏、八角寨仙境日出云海3天游	户外活动	None
【树舍出品】零基础【素描】课	沙龙学堂	None
【每周三/六出发】最美的金秋--韶关南雄坪田银杏2天游	户外活动	None
操心双十一还不如去旅行| 漫山树叶微黄，寻找梦幻法式小镇	户外活动	None
【色达 稻城亚丁 9日游】朝圣赏金秋之旅	户外活动	None
衣橱新宠――羊绒大衣亲手做！	DIY手作	None
【你的专属化妆课】手把手教你画出精致妆容	DIY手作	None
金华十里 红枫古道 浪漫穿越，人少景美！	户外活动	None
架子鼓一对一体验 | 会打架子鼓的女孩最帅气！	文艺生活	None
Barbara 趣味英语交流课 | 日常英语能力提升！	沙龙学堂	None
【深秋寻色】 徒步浙西临石古道，赏指南村红枫银	户外活动	None
徒步临川古道，赏指南村红枫与银杏美景！	户外活动	None
【醉美秋色】醉看红枫如锦  黄南古道	户外活动	None
《千与千寻》久石让宫崎骏动漫音乐派对	派对聚会	None
【约TA交友聚会】11月12日周六，精品单身白领下午茶聚	派对聚会	None
宁心定意，福慧双修――《四十二章经》抄经	文艺生活	None
我们去开房吧！第5期	派对聚会	None
威士忌入门品鉴会，体会威士忌的真谛	沙龙学堂	None
【松坪沟2日游 】人少景好小九寨，水光最美五彩池	户外活动	None
墨门演讲第四期 | 分享独特的观点、非同寻常的故事和独一无二的思想	沙龙学堂	None
瑜伽课开班啦！一起修身养性！	运动健身	None
10.31 | 考拉食验室 - 据说这是万圣节最好玩的P	派对聚会	None
奢华别墅里的素描课，素描是绘画的基础	文艺生活	None
指尖上的艺术：粘土手作【赠精品咖啡】	DIY手作	None
爱的表达----粘土八音盒DIY！让我们一起开心的捏捏捏吧！	DIY手作	None
"2016上海【万圣节】主题活动 超级怪诞世界嘉年华 （全年龄段人士,包括儿童）"	派对聚会	None
2016万圣节重磅活动魔女惊魂主题惊悚派对（天津站）| 众魔狂欢?颜值逆天	派对聚会	None
陶艺体验 手工马克杯 水杯茶杯制作 彩绘上釉烧制 记艺陶	DIY手作	None
2016【万圣节】重磅活动魔女惊魂主题惊悚派对（深圳站）| 众魔狂欢?颜值逆天	派对聚会	None
SO CINE SO CAFE 星空放映会 || 万圣的恐惧	文艺生活	None
【寒冷冬日，手套DIY】为自己做一幅萌系手套吧	DIY手作	None
2016万圣节重磅活动魔女惊魂主题惊悚派对（珠海站）| 众魔狂欢?颜值逆天	派对聚会	None
一个月学会尤克里里！大黄尤克里里火热招生中！	文艺生活	None
【交友活动】万圣夜鬼不休 | 每天还在开会，不如过来聚会	派对聚会	None
2016万圣节重磅活动魔女惊魂主题惊悚派对（碑林站）| 众魔狂欢?颜值逆天	派对聚会	None
亚洲最大红叶观赏区   古长城  一日游	户外活动	None
【海洋乡银杏】赏银杏+西街泡吧+遇龙河骑行+世外桃园	户外活动	None
万圣节南瓜主题的花艺活动【我与南瓜有个约会】	DIY手作	None
万圣女巫手指饼干＆万圣小妖DIY	DIY手作	None
2016万圣节重磅活动魔女惊魂主题惊悚派对（雁塔站）	派对聚会	None
diy手工制作一个树叶木碟子	DIY手作	None
【黑水彩林2日游】观亚洲最大红叶彩林 奶子沟 哈姆湖	户外活动	None
【元旦 】封冻的美景、不冻的热情――纵情雪乡，风情俄罗斯远东	户外活动	None
2016上海万圣节活动魔女惊魂大型惊悚主题派对（二）	派对聚会	None
2016上海【万圣节】活动 魔女惊魂大型惊悚主题派对 | 众魔狂欢?颜值逆天	派对聚会	None
2016万圣节重磅活动魔女惊魂主题惊悚派对（越秀站）| 众魔狂欢?颜值逆天	派对聚会	None
茶修游学 | 武夷山	茶会雅集	None
准备好了吗？| 2016，万圣变妆古堡奇遇夜，等你前来	派对聚会	None
2016万圣节重磅活动魔女惊魂主题惊悚派对（成都站）	派对聚会	None
11.5 享受亲子时光，绘画秋的绚丽色彩	文艺生活	None
当神秘园遇见班得瑞音乐主题派对	派对聚会	None
2016万圣节重磅活动魔女惊魂主题惊悚派对（朝阳站）| 众魔狂欢?颜值逆天	派对聚会	None
服装裁剪系列课程  /  带你遇见最美的自己	DIY手作	None
2016万圣节重磅活动魔女惊魂主题惊悚派对（东城站二）	派对聚会	None
【音痴福利】重塑大白嗓 你唱歌也可以很动听	沙龙学堂	None
【Artcle零基础艺术活动】 来自土耳其的湿拓画	DIY手作	None
书法剪纸	DIY手作	None
2016万圣节重磅活动魔女惊魂主题惊悚派对（上城站）	派对聚会	None
唯美狼杀灯伴你周末狼人杀	派对聚会	None
2016万圣节重磅活动魔女惊魂主题惊悚派对（杭州站）	派对聚会	None
原生态扎染体验课	DIY手作	None
2016万圣节重磅活动魔女惊魂主题惊悚派对（南京站）	派对聚会	None
唱歌/声乐 单曲提升课  唱一首你喜欢的歌	文艺生活	None
一日木匠diy|成人木作手工木盘、木砧板、木手镯、木家私定制课程	DIY手作	None
油画初体验‖YIMO・莫奈睡莲	文艺生活	None
手工皮具，有温度的万能眼镜盒	DIY手作	None
【朋友圈狭小不怕】相聚外滩，共赏夜景，把酒言欢！	派对聚会	None
走进木艺的世界，不甘于平庸为生活设计	DIY手作	None
2016万圣节重磅活动魔女惊魂主题惊悚派对（东城站）| 众魔狂欢?颜值逆天	派对聚会	None
不忘初心，安放漂泊：零基础古典吉他体验课 让我们一起弹吉他、谈梦想吧！	文艺生活	None
七宝珐琅烧 | 火焰点燃的饰品，惊鸿一瞥间就让人迷恋！	DIY手作	None
【剑道体验】圆每个人心中的侠客梦	运动健身	None
优雅零基础体验 这个冬天让小提琴温暖你	文艺生活	None
克服紧张尴尬癌，从容优雅讲故事 | 演讲将成为你改变的开始！	沙龙学堂	None
油画.彩铅.水彩绘画沙龙 | 零基础也能带走一幅完美之作	文艺生活	None
跆拳道：弘扬跆拳道精神，加强武道修养	运动健身	None
复古风潮少女心？来这里体验一把欧式刺绣体验	DIY手作	None
油画零基础体验买一送一！！尽情施展你的艺术天分吧！ 【油画活动太多 有重复】	文艺生活	None
【周末逛展】如是他闻｜国际摄影大师联展	文艺生活	None
熔岩巧克力蛋糕，滚烫的爱	DIY手作	None
架子鼓体验课！一节课带你动次打次”！come on	文艺生活	None
【最后的观星季，特惠反馈】广东第一峰顶露营，看壮丽日出最美星海	户外活动	None
个性私教定制，我要的不止是瘦！还要塑形！	运动健身	None
零基础学架子鼓 永远年轻永远热泪盈眶	文艺生活	None
手工短皮夹 | 自然复古，精致个性，一个皮夹就是一生的陪伴	DIY手作	None
绘画课程开始报名了 | 开始学画画，是因为有太多的东西想表达	文艺生活	None
当久石让遇见理查德克莱德曼	派对聚会	None
【最后的红色疯狂】年度最热红叶观赏区の坡峰岭	户外活动	None
10月22日 福匠零基础香道――香薰蜡烛手作	DIY手作	None
一起拼豆豆吧	DIY手作	None
水彩插画零基础班 | 让流动水彩凝固，绘制属于的你美好	文艺生活	None
芳香手作 | 有机天然高端润唇膏口红diy课程	DIY手作	None
【魔术速成】近景小魔术，撩妹神技能！入学即会！	沙龙学堂	None
玩转雪乡 带你深入东北 长白山 哈尔滨 | 最有温度最有价值的路线	户外活动	None
拾光绘画艺术空间 | 我在这里等你，等你一起与美的相遇 ……	文艺生活	None
【四姑娘山2日】出发东方的阿尔卑斯  深度观山之旅	户外活动	None
形象，是女人最美丽的名片！	沙龙学堂	None
呃...没有标题 |　标题菌去学画画了！大画酱秋冬上新菜，你来吃吗！	文艺生活	None
零基础油画【工作之外】	文艺生活	None
绝代有佳人，幽居在空谷――工笔仕女画	文艺生活	None
轻松激发原力 感受快乐燃脂 MoreFun魔方运动健身月卡	运动健身	None
假装在旧时光的河畔 零基础古筝体验	文艺生活	None
左邻右舍|左右约绘吧：画出好心情	文艺生活	None
鸡尾酒课程：专业指导，2小时让你成为调酒师!	DIY手作	None
声乐一对一体验课 | 一节课学会唱高音，从此做麦霸	文艺生活	None
风靡亚洲的Pony美妆 | 学习当代美妆大咖们的经典时尚造型	沙龙学堂	None
【周末出逃】徒步莫干山，探访上海后花园	户外活动	None
古法研磨皂手工皂制作体验（两店任选）	DIY手作	None
【英语】西方文化（深度内容）-美国文化	沙龙学堂	None
良夜留给书籍，今晚做只皮书签	DIY手作	None
【每周六、日】惠东黑排角、看怪石、观骇浪、原生态海岸线穿越	户外活动	None
陶艺、泥塑、彩陶、零基础油画体验课	DIY手作	None
YIMO‖爱宠大机密	文艺生活	None
这个”冬天”最值得去的地方，你别错过了！	DIY手作	None
独栋别墅里的私人音乐课（可体验，可包养）	沙龙学堂	None
十一黄金周，九款鸡尾酒带你尽情纵享假日缤纷。	文艺生活	None
【每周三、六 】西冲二日游：烧烤+看日出+杨梅坑单车+CS野战	户外活动	None
【国庆节】惠东黑排角海岸线激情穿越一日游	户外活动	None
国庆4-6：【红海滩】，笔架山，九门口长城3日游	户外活动	None
京剧耐人寻味，韵味醇厚。――京剧学习	文艺生活	None
DIY零基础绘画|三小时带走属于自己的油画/水彩/彩铅	DIY手作	None
深圳南澳西冲沙滩 海边烧烤 真人CS野战 快艇登岛 西冲沙滩一日游	户外活动	None
你咋不上天呢？在海边小镇体验滑翔伞飞行，想要飞的看过来！	户外活动	None
新店开幕，专属十一假期献给不凡的你 ――【国庆】‘弦乐专场’ 10月1日-10月2日	文艺生活	None
多人联机VR互动体验 | 打怪升级、解锁新阶段、获得新武器、达成新成就	派对聚会	None
【国庆两期】乌兰布统草原?金色的秋--一个适合撒欢的地方	户外活动	None
艳遇桂林阳朔”游漓江，西街泡吧之旅	户外活动	None
国庆假期，畅游天下奇观红海滩、神奇天路笔架山、九门口水上长城！	户外活动	None
雾漫郴州 小东江 丹霞地貌高椅岭 仰天湖大草原骑马	户外活动	None
漫步深圳最美海滨栈道，行摄海岸风光，相拥碧海蓝天	户外活动	None
精致生活，从好的食具开始	DIY手作	None
封存千年山水画 天津北极 登天道 观瀑布 九寨小洞天	户外活动	None
{国庆3日}国庆节 娜娜带你去库布齐 感受沙漠豪情 你是风儿我是沙~	户外活动	None
郴州仰天湖草原骑马，雾漫小东江、高椅岭徒步3天游	户外活动	None
【画・时光】暂别忙碌生活，享受手绘时光	户外活动	None
塞上秋色 阿斯哈图石林 达达线  达里湖 四日大环线	户外活动	None
一扇朝海的窗，静看岁月流淌―――博鳌4天3晚	户外活动	None
diy鹿角木盘子――这样的木盘子可以用一辈子	DIY手作	None
【国庆巨献】重返17岁之葛仙山、风情镇青春时光行	户外活动	None
【国庆6期】秋天的童话坝上草原，坝上策马奔腾	户外活动	None
教你手捏软陶多肉----从此不用再担心多肉养不活	DIY手作	None
萌萌哒精油手工皂+美美哒果冻蜡烛DIY	DIY手作	None
周末室内体验皮具DIY的乐趣	DIY手作	None
周五晚上的皮具课，增加新样式啦~预定为准哦~	DIY手作	None
{国庆3日}上帝的指纹―波浪谷壶口瀑布-波浪谷-红石峡-碛口古镇访古寻幽	户外活动	None
【竹林闲游，轻松徒步】星溪线徒步，漫步竹林，溪头村品尝竹筒饭豆腐花	户外活动	None
福匠零基础香道课程――秋日丹桂香膏＆唇膏	DIY手作	None
【国庆｜色达 年保玉则5日之旅】朝圣转湖，寻找心的声音	户外活动	None
国庆节深圳红排角海岸线徒步穿越，欣赏东部红色海岸线活动正在召集	户外活动	None
吉他弹唱体验课~和吉他去旅行~	文艺生活	None
我在你的世界行走歌唱――艺分声乐体验课	文艺生活	None
徒步漓江画廊-登老寨山-骑行阳朔-遇龙河漂流	户外活动	None
寻梦湘西凤凰古城艳遇一座城，探访神秘德夯苗寨	户外活动	None
染出秋季靓丽的风景――扎染围巾	DIY手作	None
国庆假期：进军世界奇观龙脊梯田 游阳朔山水	户外活动	None
双龙峡 京西小九寨 做小火车赏红叶 观百潭瀑布	户外活动	None
【国庆假期】金秋木兰深度游  摄影专线  红山军马场  公主湖	户外活动	None
【国庆专线】10.1-10.2 星空与云海之约――括苍山，日出、大风车、星空	户外活动	None
天赋测试+静默实验，每期仅限七人，探索有趣的灵魂	沙龙学堂	None
【达瓦梗扎神木垒2日】观光摄影 神仙居住的地方 品质高住店	户外活动	None
【然Hope屋】一针一线 一念净心 民族风手工皮具	文艺生活	None
当文艺遇上热血，一起做木质瑞士军刀！	DIY手作	None
女人写字，如花静放｜东单三好书院书法国画课程	文艺生活	None
点缀腕间风情――自制一件专属的手镯吧	DIY手作	None
DIY油画手机壳 | 举手投足间的艺术	DIY手作	None
池坊花道 | 学习日本最古老的花道，做一个优雅的女人	DIY手作	None
品毓学堂 | 品真茶事招生	茶会雅集	None
全系统咖啡培训班	沙龙学堂	None
周五嗨整晚【23号】艺分之捌社鸡尾酒音乐之夜cocktail＆music night	派对聚会	None
赏千亩梯田、攀冰川遗址―覆卮山石河群	户外活动	None
手工皮具――简约轻奢・钱夹制作！	DIY手作	None
爆笑即兴剧――十一旅行糟心手册	派对聚会	None
SO CINE SO CAFE星空放映会Vol.7----一起来看电影	派对聚会	None
莫干山赏秋色”古道人文―单天徒步穿越国家级登山步道	户外活动	None
国庆假期：乌兰布统大草原赏醉美秋色	户外活动	None
9.24（周六）喇叭沟门赏秋行摄、瑜伽之旅1日游！（还有位置欢迎报名9.23更新）	户外活动	None
【私人订制】尤克里里体验课 | 爱上这种小巧便携的乐器	文艺生活	None
奥运新项目 攀岩新体验 | 北京最好的室内岩馆之一，欢迎你的到来	运动健身	None
11.5-11.6 穿越仙居公盂仙境 露营+星空+篝火	户外活动	None
"广州学尤克里里,只要你爱音乐，爱吉他，就赶快加入我们吧"	文艺生活	None
【风车情缘】10.15-16 结伴去东白山，露营、看星星、看日出	户外活动	None
周末，天津北塘码头，带你出海带你浪~	户外活动	None
9.24-25登广东之巅广东第一峰看绝美云海、万里星空	户外活动	None
国庆假期，畅游天下奇观红海滩-神奇天路笔架山-九门口水上长城	户外活动	None
吉他一对一体验课 | 文艺青年必杀技能----吉他弹唱【送吉他一把】	文艺生活	None
【国庆假期】桂林烟雨漓江+十里画廊+西街泡吧+龙脊梯田	户外活动	None
9月24日语零基础试听课｜让轻私塾告诉你日语有多好讲！	文艺生活	None
{国庆7日}【呼伦贝尔边境】经典线路边境大环线，大草原，白桦林，满洲里，边境	户外活动	None
H.linx酒吧狂欢夜 | 明星最爱去的酒吧，狂欢的夜晚，让你惊喜到尖叫！！！	派对聚会	None
【彩虹跑】青春，就要跑出色”！	户外活动	None
Goddess美妆席卷今夏， 姑娘们靓起来！	DIY手作	None
【攻防箭】【团建】嗖嗖箭客，轻奢体育竞技，团建新选择！	运动健身	None
专属蛋糕DIY | 尽情体验手工烘焙的愉悦	DIY手作	None
一日石林峡悬空玻璃 | 不用说别的！你肯定没见过这样的眼睛”！	户外活动	None
你一定没见过BOSS 的生日邀请函 | 就算是水逆，也无法阻挡你的美丽	沙龙学堂	None
内环零基础学尤克里里，学完还能把琴带回家	文艺生活	None
飞艇逐浪，抓海胆，逮螃蟹，大甲岛烧烤露营狂欢，杨梅坑骑行看海景	户外活动	None
零基础油画 | 中秋盛宴，我等你来赴约~	DIY手作	None
【国庆】乐游金秋上海，众赏外滩夜景10月5日	户外活动	None
烘焙DIY | 新鲜甜蜜，浪漫一夏	DIY手作	None
《千与千寻》久石让宫崎骏动漫音乐主题派对	派对聚会	None
【国庆假期 】 芦芽山―万年冰洞  龙洲丹霞  波浪谷  碛口古镇 经典摄影之旅	户外活动	None
首饰品制作 | 一件精致的首饰是最长情的陪伴	DIY手作	None
【锦上添色”】11.20  蒋公道徒步，在民国风情中见秋色――红枫，银杏	户外活动	None
【周末】相约玉渡山：寻找大自然最原始的绿色记忆（1日活动）	户外活动	None
【国庆四天超值低价】走天涯海角，游魅力三亚”海南深度汽车品质游	户外活动	None
驰骋大西北，用生命演绎秋色，7日深度体验（青海湖 ・ 茶卡盐湖 ・ 敦煌 ・ 额济纳大漠胡杨）	户外活动	None
在安静的老洋房里作画 | 远离城市的喧嚣，体悟笔尖的美好	文艺生活	None
在安静的老洋房里作画 | 远离城市的喧嚣，体悟笔尖的美好……	文艺生活	None
喜乐KTV麦霸唱歌训练营，爱唱歌，你就来！！！	文艺生活	None
【周末】探寻黑排角海岸线：徒步、观海、漫步沙滩、抓螃蟹	户外活动	None
每周五出发厦门鼓浪屿 厦门大学、南普陀寺惊喜之旅三日游	户外活动	None
【第4期】我们去开房吧！	派对聚会	None
秋天，就让闺女这样穿！	DIY手作	None
英德天门沟徒步行摄，森林树屋|网梯|吊桥|瀑布|潭子|美食	户外活动	None
登高峰尽揽千山万壑  京东大峡谷  528米的京津冀最长玻璃栈	户外活动	None
【雅蕾舞蹈】来一场和自己心灵的对话！	运动健身	None
偷得浮生半日闲 一针一线好时光----厦门欧式刺绣课程	DIY手作	None
杭州撕名牌找哪家？这里带你撕X带你飞”！	派对聚会	None
烘焙课堂|这个中秋，亲手做超人气半岛港式奶黄月饼”	DIY手作	None
带你去南戴河畅享海鲜季，抓紧报名啦！！！	户外活动	None
【然Hope屋】木工体验：做一个温润柔和的木质手作，把温度留在木器之中	DIY手作	None
仰天湖草原牧歌，徒步丹霞高椅岭，雾漫小东江	户外活动	None
【金秋梯田，确定出发】游走连山原生态的欧家梯田，品农家美食，千年南岗瑶寨摄影2日游	户外活动	None
针对性指导，用真正油画颜料，绘制传统油画	DIY手作	None
零基础K歌 | 唱歌跑调，你还在KTV里默默地啃爆米花吗？	沙龙学堂	None
【毕棚沟2日游】金秋 山水相间 休闲纯玩	户外活动	None
西冲沙滩、CS野战、海泳、快艇一天游	户外活动	None
穿越金色龙脊梯田-漫游阳朔甲天下风光	户外活动	None
国际猫赛?萌猫互动?喵妆派对 | 喵星人侵占地球， 颤抖吧，人类！	派对聚会	None
脂肪回收，两周收5斤	运动健身	None
【中秋节】湖南凤凰古城、 德夯苗寨、远观矮寨四天游	户外活动	None
一墨约绘下午茶 | 这个世界，唯有美食与画不可辜负，你，要一起来吗？	文艺生活	None
【遇见，厦门】厦大-曾厝-环岛路-鼓浪屿	户外活动	None
心理学潜意识沙龙	沙龙学堂	None
草间弥生：狂人南瓜	文艺生活	None
雕刻r光之旅――橡皮章DIYwn	DIY手作	None
杭州，侬好，我们来了~（大提琴小提琴零基础体验趴）	文艺生活	None
黑暗听歌会丨每个人心中都有一朵蓝莲花――许巍专场	派对聚会	None
【独家】深度川西北游：九寨沟、黄龙、毕棚沟、九曲日落、若尔盖花湖7日线	户外活动	None
芭蕾体验～感受天鹅式的优雅	文艺生活	None
扎营人间天堂，醉美八排山草原露营	户外活动	None
春晓夏眠，书法映像，颜体【书法】学习精品小班	文艺生活	None
当摄影师遇上咖啡	文艺生活	None
风雅团扇，不只是乘凉	DIY手作	None
【国庆假期 】 ・时间的指纹・库布其沙漠  波浪谷B线	户外活动	None
魔都金秋相聚，我跟白领有个约会！DIVA酒吧狂欢！	派对聚会	None
追寻最后的花季   赏京北四季花海  百里画廊   珍珠湖  赏花  摄影  休闲	户外活动	None
仙乐飘飘经典电影主题音乐派对	派对聚会	None
植物蓝染 | 由染而生，让植物融于生活	DIY手作	None
YIMO STUDIO||情侣绘画作品课 | 找一个慢悠悠的下午 带着TA一起来画油画吧	文艺生活	None
【易乐木艺】创意木艺DIY・发簪课	DIY手作	None
拒绝失败案例拒绝千篇一律网红｜我们要拥有自己的气质	沙龙学堂	None
【休闲摄影】延庆四季花海----最美乡村，梦幻般的花之王国	户外活动	None
顽皮马零基础手工皮具体验课程 | 制作一枚清新精致的牛皮卡套	DIY手作	None
魔都高逼格天台 | 品美酒聊人生，看外滩美丽夜景	派对聚会	None
初级课程|古琴&国画―写意花鸟&书法&茶道	文艺生活	None
神奇天云山，北方张家界~云中漫步玻璃大桥，体验飞一般的感觉！	户外活动	None
增强现实AR真人RPG之营救特工，打破传统密室玩法，加入跑男元素	派对聚会	None
品茶2小时｛发呆、看书、听音乐｝	茶会雅集	None
【逸汇・雅音】暖秋 ・ 爱情篇 / 一个插曲，一件小事。	文艺生活	None
花艺课 | 不谈爱情，只讲讲永恒之美	DIY手作	None
来做壹日艺术家－艺术区的零基础油画大师课	沙龙学堂	None
国庆假期 出发北京最近的草原-张家口黄龙山庄【云中草原】绝美花海  清凉盛夏	户外活动	None
乌龙茶初体验――用心泡好一壶茶	茶会雅集	None
【北方小乌镇 】 古北口水镇----司马台长城   一日休闲活动	户外活动	None
3D立体冰皮月饼DIY，中秋技能提前get!	DIY手作	None
手作羊毛毡兔子 | 最温暖的陪伴	DIY手作	None
衣锦高级形象定制（一对一）体验 | 找到自己的独特风格，成就美丽人生	DIY手作	None
夏末秋初四季花海，魅力永宁古城”休闲一日游	户外活动	None
东方精致：氤氲中的太平盛世	沙龙学堂	None
梦幻树脂吊坠DIY，文艺青年必备单品	DIY手作	None
【清凉夏日】末伏盛夏，去峨眉山下探寻最清澈的一抹绿池 峨眉张沟单日徒步戏水	户外活动	None
法式小花束课程 -- 原气花铺花艺体验课程 -- 野兽派花艺师亲自教学	DIY手作	None
神秘园＆班得瑞音乐主题派对	派对聚会	None
有肉”的日子，最幸福	DIY手作	None
短钱夹的前世今生，属于你的指纹温热附属品	DIY手作	None
唱歌/声乐 单曲提升课-唱一首你喜欢的歌	文艺生活	None
手提花袋插花体验课程 | 让你的生活得到绽放	DIY手作	None
2016 最火黑科技-年轻人再不体验VR和咸鱼有何区别用	派对聚会	None
一起学尤克里里 | 学一门乐器，为亲爱的人弹一首歌！！！	文艺生活	None
艺术在场手工体验项目【陶艺篇】感受陶艺生活之美	DIY手作	None
君子动手不动口 零基础DIY手工皮艺	DIY手作	None
燃脂轰趴!一种会上瘾的运动，边流汗边狂嗨~~	运动健身	None
带你进入VR虚拟现实的奇妙世界，在这里没有不可能！	派对聚会	None
周末云中漫步”玻璃桥已横空出世，快来体验这令人惊叫的感觉吧！	户外活动	None
每周三/六 西冲欢乐二日游 烧烤+看日出+杨梅坑单车+CS野战	户外活动	None
击剑体验 | 击剑是一种优雅的剑术决斗	运动健身	None
一半城市・一半山涧 | 自助烧烤BBQ狂欢夜	派对聚会	None
艺术在场手工体验项目【花艺篇】回到了小时候的那片花园	DIY手作	None
艺术在场手工体验项目【咖啡篇】体验和感受自己动手制作咖啡的满足感和成就感。	DIY手作	None
尤克里里一对一体验课 | 文艺细菌燥起来【送尤克里里】	文艺生活	None
【盐州岛】滩涂、海滩、鹭鸟、日落、礁石、美丽的盐洲岛两日游	户外活动	None
另一种风景 | 国内外18位非常优秀的当代摄影艺术家作品展	文艺生活	None
游木n堂|第三n：好食器就像魔法师能撩起胃口	DIY手作	None
千岛湖的世外桃源・千岛湖森林氧吧	户外活动	None
烘焙课程 | 为爱烘焙	DIY手作	None
8.27香水DIY沙龙 | 做自己的调香师，定制你的专属味道！	DIY手作	None
猫咪寄养和玩耍~~欢迎来到猫咪幼稚园~	文艺生活	None
【儿童】软笔\\硬笔书法体验课  十年以上专业老师上课	沙龙学堂	None
飞行+高尔夫 轻奢避暑新主张（第二季）	户外活动	None
一咖啡――中秋冰皮月饼DIY | 把浓浓的思念装进美味的月饼里	DIY手作	None
陶瓷DIY，周末我最嗨	DIY手作	None
有故事的永生花，零基础也能做出一个童话世界	DIY手作	None
深入蒙古族草原 看银河星空・烤全羊・亲近动物~	户外活动	None
赵无极 ｜国际华人大师收藏展 艳夏漫漫	文艺生活	None
横扫生活无趣与颓废|21计划，满足你人生所有美好生活的幻想	文艺生活	None
【逸汇・雅音】暖秋 ・ 梦想篇 / 音乐 / 远方 / 诗	派对聚会	None
轰趴私人派对酒会场地半价优惠！	派对聚会	None
重塑风格  11月周末班名额抢购中	沙龙学堂	None
爵瑟夏夜・电音鸡尾酒派对 | 谁说中国人不会玩派对，我们就是传统的颠覆者！	派对聚会	None
两天一夜 |10.2-10.3面朝大海，露营在无人荒岛竹屿岛”，传说中的中国济州岛	户外活动	None
精彩美丽体验课，感受美丽的涵义！	文艺生活	None
【昌岗】暑假游泳培训班开班啦！！	运动健身	None
上海最美野骑路线（6公里野骑+公园门票）	户外活动	None
【8.13周六】  跋山涉水去寻找隐世的清幽之地，穿越麻柳沟溯溪戏水徒步	户外活动	None
【品质溯溪】8.14号  溯溪丽人谷，探最纯的水质峡谷――华东水质最好的峡谷之一	户外活动	None
男女双打桌球比赛	派对聚会	None
马背上的男人总是更潇洒，女人更有魅力 | 场内教学+3公里野外骑行	户外活动	None
我们的七夕，无言的唯美 | SOCAFE星空放映会之《试验》	文艺生活	None
金秋九月 | 画一副油画送给亲朋好友	DIY手作	None
摄影大师教你，把手机变成超级单反	沙龙学堂	None
民国小吃节+戏曲文化节 | 一起去探秘民国时代绚烂的美食文化吧~~	茶会雅集	None
浪漫七夕，亲手为你们做一份木工礼物	DIY手作	None
乐感声音比别人好，总是些微让人与众不同的小确幸。	文艺生活	None
【泸沽湖4日游】出发探访最后的摩梭女儿国	户外活动	None
蛋雕，玩的就是心跳	DIY手作	None
银匠之手工银镯 | 那被岁月打磨的银，分外美丽	DIY手作	None
四合院里全手工打造一盏小木灯，点亮幸福	DIY手作	None
舞蹈体验 | 选择舞蹈，选择一种热情而优雅的生活方式	文艺生活	None
【甜鹿烘焙DIY】七夕，走！第二份半价！	DIY手作	None
你挥拳的样子，最帅，最美!	运动健身	None
七夕趣玩｜做一份提拉米苏，带TA走	派对聚会	None
树脂遇上木头 | 最独特的项链	DIY手作	None
这可能是杭州G20前最后的狂欢--不能说的秘密”主题派对！	派对聚会	None
手写的浪漫情怀|DIY木质笔	DIY手作	None
油画带你走入多彩的艺术世界，你也可以是画家！	文艺生活	None
陈氏太极拳基础养生体验课 | 内外兼修，延年益寿	运动健身	None
色彩夏日――单身狗七夕派对	DIY手作	None
【清凉夏日】 8.6周六 蟠龙谷戏水玩瀑布，远离夏日酷暑 单日溯溪徒步	户外活动	None
一块木头的华丽变身手镯DIY	DIY手作	None
企业瑜伽 ―― 给员工最好的身心保障	运动健身	None
零基础做汉服 | 典雅柔美，尽情展现大汉风华	DIY手作	None
当久石让遇见理查德・克莱德曼	派对聚会	None
2016中国（南京）宠物文化节 | 带上你的爱宠一起来趴踢！！！	派对聚会	None
东山 DONG SHAN ― 从面向大海的苏峰上到东山的阳关沙滩	户外活动	None
下午茶沙龙，给你不一样的香浓体验	茶会雅集	None
暑期钜惠！用一种文艺的方式遇见成都的小确幸！	DIY手作	None
复古搭配  手工皮具笔记本，护照包，驾照包	DIY手作	None
外貌协会看过来 | 邀你来京城最有逼格的天台，邂逅最美夜晚	派对聚会	None
瓶子里的小世界”由你定义	DIY手作	None
2016最爱吃货节（北京站）	派对聚会	None
【小清新的美好时间】一起来画水彩吧	文艺生活	None
史努比现身环球MALL，跟全球热门明星”一起陪你梦想大未来	派对聚会	None
乐在木艺，独在匠心 |DIY木艺制品	DIY手作	None
【清凉一夏】8月7号 野外溯溪+户外美食+水枪大战	户外活动	None
陌绘零基础油画 | 咖啡馆能画画有美食可交友才叫生活	文艺生活	None
音痴福利！拯救你的大白嗓！（声乐体验课火热报名中~)	文艺生活	None
全民大侦探 | 比VR、AR更带劲的真人互动RPG推理游戏你敢玩么！	派对聚会	None
【周末】探寻上海最隐秘海岛|大洋山环岛徒步、看海、吃海鲜活动	户外活动	None
拿起画笔来惊艳四座，零基础油画豪华套餐体验	DIY手作	None
七夕御守@亲手缝制爱的护身符	DIY手作	None
幽默养成记 | 教你用风趣和创意为表达添彩！（周末工作坊）	文艺生活	None
话剧表演 | 不能拼颜值那就拼演技！（周末体验课）	文艺生活	None
坐在大雄的教室里，我们一起「玩桌游」「吃零食」回顾那些好时光吧	派对聚会	None
即兴喜剧 | 教你用好玩的沟通方式改善职场人际（周末）	文艺生活	None
今天，为了你心爱的人一起来学推拿吧!!!	沙龙学堂	None
Gene's Way绘画沙龙-每周六下午两点	沙龙学堂	None
私房精品小提琴体验课 [艺分之捌社]	文艺生活	None
时尚芭比，由你来创意	DIY手作	None
书写优雅，从笔开始| DIY木制笔	DIY手作	None
So Cafe动手做”之--做自己的创意手账本	DIY手作	None
【DIY押花】沏一杯好茶，与你一起寻古觅花	DIY手作	None
海上轰趴：游艇观海景+鱼排海鲜大餐+休闲海钓一日游	户外活动	None
国庆假期【欢聚东戴河】原生态海滩 温馨渔家住宿 吃海鲜大餐2天休闲活动	户外活动	None
8.07品酒沙龙|葡萄酒达人公开课:从开瓶到品酒！	沙龙学堂	None
惠东碧桂园十里银滩、清泉古寺2日游	户外活动	None
【周末】：访古道，入竹海，享清幽，上青古道秘境探寻1日活动	户外活动	None
116艺术学堂 多彩的玻璃（马赛克镶嵌）体验课程	DIY手作	None
［油画班的春天］艺术热情，不负春光――零基础学油画	文艺生活	None
零基础+丙烯油画+咖啡果茶，带你体验慵懒下午茶，享受慢生活	文艺生活	None
"零基础油画 | 艺术,不是一件遥不可及的事情"	文艺生活	None
小U限时半价 零基础学一首圣诞曲	文艺生活	None
我们一起私奔吧--就现在（我们在珀丽酒店见）	派对聚会	None
国内首个交互式VR体验馆----抉择虚拟现实体验馆 | 抉择面前，一切由你掌控！	派对聚会	None
暑假约会必备！最炫迪士尼cupcake，零基础！！	DIY手作	None
VR虚拟现实体验  感受未来  【59.9元/1小时】抢枪抢！！！（限一人）	派对聚会	None
［手工皮具］爱上手作生活～爱上皮具体验~	DIY手作	None
国庆假期 走进十渡仙西山    免费赠送80元拒马河漂流	户外活动	None
和琵琶的十次约会	沙龙学堂	None
邀您一起来学最女人的舞蹈----弗拉明戈	文艺生活	None
摄影师空格 | 我知道，你我会拥有一场最美的相遇。	文艺生活	None
比密室还好玩的实景探索推理游戏！	派对聚会	None
风水讲堂 | 知天命，尽人事，过好每一天！	沙龙学堂	None
~*个人化妆基础造型班，让你秒变完美女神~*	沙龙学堂	None
飞行+高尔夫 轻奢避暑新主张	户外活动	None
diy木项链――为文艺的自己添一吊坠	DIY手作	None
【爱的纪念日】亲手打造专属于你们的情侣对戒	DIY手作	None
黑盒子|密室、私影、体感、桌游任意玩	派对聚会	None
非洲鼓一对一体验课 | 简单的乐器，欢乐的曲调【送非洲鼓】	文艺生活	None
吉他速成课 | 学习一种简单的乐器，不为大世界，只为心中的小愿望	文艺生活	None
习古琴 表法修身	文艺生活	None
扎染不能停！	DIY手作	None
零基础学油画  重拾你的艺术梦	DIY手作	None
霞天采云千里光，仙鹤太子万年青――黄帝内经课	沙龙学堂	None
色彩玩家 | 扎染，把心中独一无二的色彩留在衣服上	DIY手作	None
【拒宅壹族】泼夫”泼妇”一起来撒泼吧！	派对聚会	None
diy木戒指――为彼此制作一对最美约定	DIY手作	None
【相约里约奥运】8月7日 | 首届SUPER-WET水球大战+湿身健康跑	户外活动	None
杭城首家市中心CC VR虚拟现实体验馆 酷炫必玩	派对聚会	None
漳州南靖一日游 | 探秘客家土楼，在云水间悠然信步	户外活动	None
【成人零基础学画画】 尝试那些你不会，却美好的事~	文艺生活	None
星球”大战――翻滚吧，Bowling	运动健身	None
皮具体验 | 挎上学院包，我们最青春！	DIY手作	None
阅影咖啡私人影院包厢预订	文艺生活	None
石林峡  挑战悬空钛合金玻璃   UFO   观景台体验心跳之旅	户外活动	None
［手工皮具］这个夏天，让手作给你降温吧～	DIY手作	None
【清爽夏日】白洋淀荷花大观园  感受万花丛中过  泛舟荷花丛	户外活动	None
下午茶的同时，其实还可以画一幅画交一群朋友	文艺生活	None
橡皮章diy| 给你盖个戳，你就是我的了~~	DIY手作	None
10元抢票进行中 │仙乐飘飘浪漫经典音乐派对	派对聚会	None
【福开森 ・ 中国艺术演讲录导读】懂一些中国艺术，生活才有味！	沙龙学堂	None
素描暑期课程 | 12次课带你玩转黑白灰	文艺生活	None
架子鼓速成课，学习一种简单的乐器，不为大世界，只为心中的小愿望	文艺生活	None
diy木质领结――型男潮扮	DIY手作	None
意大利小鲜肉为你夜读美文-BC出品	沙龙学堂	None
【极限挑战 攀岩体验】攀岩是一种向上的生活态度	运动健身	None
品毓学堂 | 剑道招生	运动健身	None
谷粒优. 休闲桌游（狼人杀）	派对聚会	None
以手为道，以心制物 | 手工皮具包包系列课程	DIY手作	None
晚上下班去哪儿嗨，拳击体验来不来	运动健身	None
陶艺DIY|带你体验陶艺之美，感受慢节奏生活。	DIY手作	None
要谈就谈场不分收的恋爱--就现在，我在这里等你	派对聚会	None
爱上奶油的面包―酥皮奶油泡芙	DIY手作	None
爱的甜蜜次方 ・ 多种甜品烘焙体验	DIY手作	None
以色列格斗术教你如何一招制敌”	运动健身	None
国庆假期  草原天路  送烤羊 最美66号公路 闪电湖 策马奔腾2天休闲活动	户外活动	None
鸡尾酒之夜-Pride Nights	派对聚会	None
射箭----内修心、外修型	运动健身	None
【忆江南】7月9号  溯溪丽人谷，探最纯的水质峡谷	户外活动	None
平日【时尚生活圈】什么决定你的审美观？审美观会改变你什么？	沙龙学堂	None
体验式下午茶×零基础画油画	文艺生活	None
魔法学堂：＃一次读一本书＃《说话之道2》	沙龙学堂	None
永定土楼一日游 | 探秘客家的民俗文化，感受独特的建筑风格	户外活动	None
仙气来袭 妖孽让路 竹笛学堂开课	文艺生活	None
籽盼璧 让我们舞一曲酣畅淋漓	运动健身	None
丁雄泉｜国际华人大师收藏展 艳夏漫漫 | 在老洋房里看展才是正经事【整年的展览，不限次数】	文艺生活	None
色彩幻想｜约旦沙瓶画	DIY手作	None
【诱惑溯溪】7月17日 杨溪腐败溯溪――水至清人又少，另有美食相伴	户外活动	None
顶绳体验 | 攀岩，你的力量就在这一刻	户外活动	None
3D多媒体电子音乐会《盒星人雷克秘境奇遇记》	暂不开放	None
F16飞行体验，女神带你离开地球表面	运动健身	None
初学者水彩课程---画笔记录日常点滴美好【新技能get！】	文艺生活	None
白洋淀1日游~映日荷花别样红！7月16日周六桔子瑜伽旅行报名中！	户外活动	None
尤克里里体验| 全城通缉令――寻找星星的主人	文艺生活	None
菊次郎的夏天--久石让钢琴曲龙猫乐队梦幻之旅演奏会（福州）	暂不开放	None
【周末】漂洋过海去舟山小洋山岛：登山、看海、观石活动	户外活动	None
【国庆节】】相约 桂林阳朔 汽车团全景游	户外活动	None
青年艺术家教你画油画，约吗	DIY手作	None
电吉他，电贝司 基础体验课程	文艺生活	None
菊次郎的夏天--久石让钢琴曲龙猫乐队梦幻之旅演奏会（湖北）	暂不开放	None
千色奇遇 ?油画体验 艺术家养成记	文艺生活	None
diy动物台灯――萌萌哒小动物台灯哟	DIY手作	None
高尔夫丨教你掌握这种高逼格运动	运动健身	None
【留香指尖】蜜蜡的前世今生	DIY手作	None
【逸汇・雅音】古筝奇弹――禅・幻・无常・合	暂不开放	None
【树舍出品】喜多的吉他班（零基础，不限课时）	户外活动	None
他的衬衣，你的长裙~	DIY手作	None
管住嘴、迈开腿！超值爱炼reborn【减脂体验课】+赠送价值59元哑铃1对！	运动健身	None
十渡东湖港竹筏戏水，激情漂流：给你一个清凉的夏天	户外活动	None
私人影吧观影，享受豪华观影体验（还有小零食）	文艺生活	None
外滩之恋，上海人专场?高端单身交友会	派对聚会	None
肇庆广宁竹海美食+竹筏登岛1日游	户外活动	None
7月3日绅士淑女单身派对	派对聚会	None
【捧河湾】  白云大峡谷摸河蚌，抓鱼，拾贝，戏水狂欢	户外活动	None
久石让宫崎骏动漫音乐主题派对~~~	派对聚会	None
北方梦里桃花源    清凉谷  戏水.爬山	户外活动	None
【零基础】上海直升机驾驶体验，不止飞更畅玩	户外活动	None
想和全球明星真人蜡像合影吗？暑期特惠，买一送一！	派对聚会	None
CityWalks  探秘魔都前生今世之秘境跑马场	户外活动	None
日本高级光疗胶美甲 | 你的手指那么美，指甲也要美美哒	派对聚会	None
畅游不老屯紫色浪漫  云峰山   薰衣草庄园	户外活动	None
中国（南京）宠物文化节  萌宠嘉年华	派对聚会	None
喵星人侵占地球名猫展?北京站	派对聚会	None
全广州最好玩最搞笑的脱口秀，爆笑来袭，停不下来~~~	派对聚会	None
"\""夏季瘦身召集令\"" 来去野，一起燃HIIT+YOGA"	运动健身	None
滴滴打拳 | 野性之美，泰国拳皇带你感受纯正泰拳文化	运动健身	None
So Cafe 动手做”之－属于你的自由式插花	DIY手作	None
一款吊带一整夏！	DIY手作	None
【线上微活动】拒绝怯场，自信面对职场，语言是你的秘密武器！！	沙龙学堂	None
可以用一辈子的皮带，有了这条就够了！	DIY手作	None
跟着匠人做出自己设计的银饰	DIY手作	None
中国宠物文化节 萌宠嘉年华	户外活动	None
DIY帽子 | 自己的帽子自己画！	派对聚会	None
让生活变成一场48小时的嘉年华	户外活动	None
搞怪皮手环，为喜欢的人做一只零距离的奢侈品	DIY手作	None
圆瓶多肉生态瓶定制DIY	DIY手作	None
墨门CAT演讲大会――极致	沙龙学堂	None
篆刻零基础活动-工作之外生活应该是这样的	DIY手作	None
创意礼物DIY小板凳亲子课程	DIY手作	None
Ukulele尤克里里 文艺青年入门必修第一课	文艺生活	None
周末来约一场酣畅淋漓的羽毛球吧！（首都体育馆）	户外活动	None
尤克里里入门课程（送小尤）	文艺生活	None
给自己做个随身物件 | 温暖的皮革，柔软的内心	DIY手作	None
平遥古城 乔家大院 赏美景 品美食快乐2日行	户外活动	None
【线上微活动】拒绝怯场，良好口才助你自信面对职场！	沙龙学堂	None
尤克里里课程| 弹着尤克里里，去那个只有我们的地方~	文艺生活	None
纪念莎翁逝世400周年之疯狂喜剧《仲夏夜之梦》（改编）	暂不开放	None
成人钢琴初体验，美女老师带你奏响梦中的高贵之音	文艺生活	None
【线上微活动】彩铅对话生活，让你在家也能get绘画技能不停歇！	DIY手作	None
街舞青春 不舞不型”	运动健身	None
游轮出海打鱼摸虾  北塘古镇   撕名牌   海鲜盛宴	户外活动	None
【飞鸟DIY】牛皮小物自己做	DIY手作	None
儿童打击乐音乐喜剧《怦客三兄弟》	暂不开放	None
【零基础手工皮艺】高逼格DIY体验从一件自做手工皮件开始	派对聚会	None
D7迎夏日燃脂健身派对	运动健身	None
父亲节献礼，为TA做件皮革小物	DIY手作	None
塔罗之眼 | 看清迷茫的内心，遇见未知的自己	文艺生活	None
在木片上画一幅油画	DIY手作	None
双子座福利月!带双子座来买一送一过艺术周末	文艺生活	None
宁心定意 福慧双修――抄经共修	茶会雅集	None
香港互动儿童话剧《我想要爱》	暂不开放	None
博羿箭游，真实版饥饿游戏	派对聚会	None
中国唯一上榜之全球最美图书馆	户外活动	None
南国剧社后现代剧场《东方快车》南京谢幕场	暂不开放	None
简单轻松零基础学油画 | 结识新朋友，发掘画画天赋	DIY手作	None
心跳之旅 | 【国庆】bungee jumping 你不是一直想上天吗？10.5-10.6	户外活动	None
我的小尤我做主（尤克里里DIY彩绘）	DIY手作	None
羽球入门课 | 全国比赛前三名手把手教你打羽毛球！(首体)	户外活动	None
【蔚蓝大海】6.18-19 鹤浦岛黄金沙滩，捉螃蟹、捡贝壳、篝火、烧烤，水晶葡萄采摘	户外活动	None
周末：华北明珠白洋淀休闲一日游	户外活动	None
"【GoART】零基础绘画 父亲节的专属礼物《My Dad,My Hero》"	文艺生活	None
2天1夜 | 神秘の鹤浦小岛，沙滩上拥抱碧水蓝天	户外活动	None
零基础油画创作体验课程	DIY手作	None
谷粒优.气质瑜伽班	运动健身	None
寻找绿箭人 | 让你一箭倾心”	运动健身	None
【休闲摄影】一起走进京郊醉美小九寨・玉渡山	户外活动	None
零基础高品质DIY油画体验	文艺生活	None
游走在都市里的剑客，邀你赴一场剑道的修行	运动健身	None
超酷炫的VR体验馆 | 把最有意思的东西，带给最会玩的你	派对聚会	None
鸡尾酒课堂 | 缤纷夏日，零基础get调酒新技能！汉纸妹纸撩起来~	DIY手作	None
【步步惊心】6.18 挑战浙江最刺激的玻璃栈道，采摘仙居杨梅	户外活动	None
ViiArt一期一会：有一个地方只有你知道	派对聚会	None
6.18，仲夏夜猝不及防的激情	派对聚会	None
白洋淀-赏万亩荷花-划小木船游芦苇荡-逛水乡王家寨	户外活动	None
全皮笔记本	DIY手作	None
10元抢票进行中│仙乐飘飘百年经典钢琴主题派对	派对聚会	None
diy制作一份生日礼物――十二星座剪纸台灯	DIY手作	None
你有病？我有yào! *论一部有情殇治愈功效的舞剧*	文艺生活	None
菊次郎的夏天--久石让钢琴曲龙猫乐队梦幻之旅演奏会（宁波）	户外活动	None
拉丁健身舞Zumba | 小蛮腰也能轻松拥有！	运动健身	None
一杯咖啡，一幅油画，一个安静悠闲的午后	文艺生活	None
不知姑娘你是谁”――何大河专场音乐会	暂不开放	None
零基础彩铅画体验课 | 自己动手创作一幅五彩斑斓	DIY手作	None
限量油画体验――绘画的深度诱惑	文艺生活	None
罐头鬼市×成都大悦城	派对聚会	None
2016北京波尔多葡萄酒狂欢节	派对聚会	None
福利：零基础古琴入门精品私教课	文艺生活	None
画出内心繁花似锦	文艺生活	None
文(B)艺(Ge)|在画里零基础??高端??环保传统油画颜料绘画体验	DIY手作	None
天下油画同萌乐	文艺生活	None
高尔夫无界线 ，超值体验 | 锻炼身体，享受大自然	运动健身	None
一曲诉衷肠 | 清雅古筝弦音回响体验课	文艺生活	None
"观看制陶流程,体验手作陶艺"	DIY手作	None
西冲欢乐一日游：西冲沙滩、CS野战、海泳、快艇一天游	户外活动	None
陶艺雕花＆拉胚体验	DIY手作	None
爆棚超值 | 老洋房里的零基础油画体验课	文艺生活	None
端午不只有粽子 还有香包 扇面和草编	DIY手作	None
天津飞行体验，过一把机长的瘾	户外活动	None
【本年最后一期，特惠反馈】大峡谷看壮丽山水，无尽飞瀑流溪宁潭	户外活动	None
【端午假期】广西黄瑶古镇，龙脊梯田梳秧节、火把节、深度徒步穿越3天	户外活动	None
Timen密室主题馆开玩啦！	派对聚会	None
【逋局旅】端午黑龙滩-孤岛露营2日	户外活动	None
周末时光，寻找老北京胡同最初的味道	户外活动	None
给萌多肉  做个美妆” | 感受肉嘟嘟带给你的”植觉	DIY手作	None
悠闲逢简水乡，游船置身古劳水乡荷花世界	户外活动	None
优雅?遇见――资深形象顾问教您形象提升	沙龙学堂	None
【国庆假期】霞涌虎洲湾露营 撕名牌 策马奔腾 篝火音乐趴 穿越虎洲岛 二日游	户外活动	None
【零基础花艺课】刷爆深圳朋友圈的高逼格活动，你玩过吗？	DIY手作	None
【端午】 象山月牙沙滩踏浪，五彩礁海岸徒步，捉拿寄居蟹，休闲水果采摘	户外活动	None
【泸沽湖4日游】探访最后的摩梭女儿国「中国爱情海」	户外活动	None
CityWalks  一起行走之虹口方舟	户外活动	None
艺宿 成人零基础油画diy	DIY手作	None
【端午节】倾情红海湾 阳光沙滩＆美味海鲜	户外活动	None
只剩30秒了，怎样才能逃出这恶魔的地狱？？	派对聚会	None
一张考卷一道命题 带你游遍上海	运动健身	None
【花道+茶会】 优雅女如何练成	DIY手作	None
【急速瘦身体验课】不敢穿比基尼的身材不是好身材！！！	运动健身	None
寻找绿箭人”，让你一箭倾心”|520特价20元一人限时优惠！	运动健身	None
高品质的烘焙体验/两款可选	DIY手作	None
为自己拉动那根优美的琴弦----零基础大提琴体验	文艺生活	None
亲手制作深水炸弹”浴盐球（两店任选）	DIY手作	None
【粽”于等到你】亲手来包端午的水晶粽子吧~	DIY手作	None
相约黄山，看云海翻腾，观日出日落	户外活动	None
幽幽兰若寺 | 上青古道，走一遍古人的国道，来一场文化之旅	户外活动	None
古筝、钢琴 | 演奏一首曲，让古典音乐触手可及。（一年内免费重修哦~）	文艺生活	None
咖啡馆里的手作时光：哆啦A梦皮铃铛	DIY	None
调酒课堂|十二星座鸡尾酒，找到属于你的那一杯！	DIY手作	None
扎染体验| 你知道文艺青年最爱的扎染到底是什么吗？	DIY手作	None
凡艺公社春季小派对，瑜伽书法茶艺插花	茶会雅集	None
Party 青年乐队摇趴	暂不开放	None
手工皮具体验课	DIY手作	None
徒步军嶂古道，爱上整个夏天	户外活动	None
【十一出逃】双重玩法 | 攀登大明山，漂流玩水！	户外活动	None
起泡酒下午茶：泡泡的奇妙之旅	沙龙学堂	None
【草坪狂欢夜】一起走进小树林	派对聚会	None
【十一出逃】高空溜索，攀岩、速降！―野玩纪龙山	户外活动	None
两小时鸡尾酒体验课，亲手调制莫吉托等四款鸡尾酒	派对聚会	None
同城活动 | 每周三 城西银泰溜真冰，你约吗？	运动健身	None
零基础丨父亲节礼物――自制花灯	DIY手作	None
【绚烂笔触 油画】ArtHouse 零基础油画课程	沙龙学堂	None
时尚沙龙｜｜如何穿出独特自我个性的美男子/美少女？	沙龙学堂	None
8月丰宁坝上大草原、策马奔腾（入秋凉）	户外活动	None
逢简水乡 走进岭南苏州	户外活动	None
【岩茶盛宴】6期茶会 尝遍名枞名种36款！！	茶会雅集	None
从《天空之城》到《起风了》――久石让电影音乐30年交响视听纪念版（上海）	暂不开放	None
缝纫菜鸟变达人的必修课-服装制作/缝纫分享交流课	DIY手作	None
CityWalks  优雅的秘密――漫步长宁繁华	户外活动	None
5/28（六） 5分钟遇见你，双子月的爱情	派对聚会	None
像日式花道大师一样幽雅的插花	文艺生活	None
久石让宫崎骏动漫音乐主题派对	派对聚会	None
绘画一场与艺术的美丽遇见	文艺生活	None
宁心定意 福慧双修――福匠抄经共修	茶会雅集	None
叶绘繁星	DIY手作	None
"花鸟绘画|倚梅园处暗生香,美人梅花两相亲"	文艺生活	None
陶艺diy成品套餐	DIY手作	None
台山狮子头休闲溯溪，喝茶泡水、秀美溪水，清凉一夏	户外活动	None
零基础花艺体验 | 奔驰迪奥御用花艺设计师带给你的花艺课	DIY手作	None
芒果小熊慕斯蛋糕，酸酸甜甜好味道！	DIY手作	None
【户外徒步】重走蒋公道，访历史名山寻遗迹――莫干山	户外活动	None
吉他体验 | 轻轻弹吉他，唱自己写的歌	文艺生活	None
克克普桌游俱乐部之狼人杀聚会	派对聚会	None
【ME绘夏季写生】用画笔记录初夏――5.29出发	户外活动	None
喜好慢生活的你 前世未了古琴心	文艺生活	None
滑翔伞飞翔体验，做一天‘鸟人’	运动健身	None
献给一生的挚爱，永生花为你表达	DIY手作	None
【中秋｜若尔盖纯玩3日游】 如果你不相信人间有天堂，那么你一定要去若尔盖~	户外活动	None
北方巨石第一园----石林峡：挑战UFO玻璃观景台	户外活动	None
有了我的专属筷子，吃饭就是香！	DIY手作	None
十渡漂流、戏水、东湖港激情一夏	户外活动	None
神话历史学博士讲中国众神系列讲座，从盘古开天到西游量劫	沙龙学堂	None
油画 | 惜取此时心，明朝即长路	文艺生活	None
梧桐绘|零基础油画体验三送一	文艺生活	None
99元高尔夫特惠之旅	运动健身	None
5.28/29鸡尾酒课堂|教你调制电影中那些经典鸡尾酒	DIY手作	None
【K歌+相亲交友】我们一起约会吧	派对聚会	None
射箭-射以观德	运动健身	None
皮具入门｜ 简单易上手 情侣纪念钥匙扣	DIY手作	None
南国剧社《朱丽叶与罗密欧》青春剧场	暂不开放	None
520 咱不聊创业撩”爱情	派对聚会	None
木艺手作 | 爱情是独一无二的，戒指也要与众不同，专属于你我	DIY手作	None
在野艺术｜8月7日成人零基础油画班	DIY手作	None
父爱的味道－一咖啡父亲节电影放映会	文艺生活	None
10月4-5号三门岛烧烤踏浪，海誓山盟峰看日出赏360度无敌海景，乘飞艇抓螃蟹抓海胆	户外活动	None
夏尔・巴蒂斯特音乐会 | 法语音乐世界，浪漫的卷舌调调	暂不开放	None
王老师的主题摄影课堂	文艺生活	None
如果你有一幅画的时间	文艺生活	None
不再做音乐界的哑巴”，我们要大声飙歌	文艺生活	None
【情侣间的特别礼物】零基础油画肖像画体验课	文艺生活	None
【周末常规】清远古龙峡漂流+瀑布群探险+小北江观光一日游	户外活动	None
【重磅推出】中国印象”音乐巡演（昆明站）：大珠小珠落玉盘	暂不开放	None
黑暗听歌会丨友谊的小船	文艺生活	None
拉坯，捏塑，泥土在你的指尖开出绚烂的花~	DIY手作	None
CityWalks  醉?静安	户外活动	None
【11月12/13日 】心动约会 ☆ 牵手成功率最高的单身交友活动	派对聚会	None
资深亲密原型师1对1为你测评亲密关系能力与能量	沙龙学堂	None
"【岩茶盛宴】第一期茶会 尝遍岩茶800款,品尽武夷火功夫！！"	茶会雅集	None
【幻茶谜经】女子的爱情和人生，亦幻亦真，这是一场没有语言的醉梦！	暂不开放	None
零基础油画|周末就该这么轻松愉快又有爱	文艺生活	None
【烘焙DIY★闲日时段二】每逢周二＆周四| 上午场+下午场	DIY手作	None
【浙西天池】11.26  徒步吴越古道，攻占千倾关，赏浙西天池美景	户外活动	None
清新系背心裙 拯救被视为女汉子的你	DIY手作	None
"增强现实AR真人RPG之营救特工,没有口袋妖怪先玩这个"	派对聚会	None
荒岛狂欢 | 521去露营，感受草坪篝火音乐趴	户外活动	None
长裙！长裙！ 女神的必备新衣	DIY手作	None
开动脑洞做清新可爱热缩片，萌炸啦	DIY手作	None
追寻逝去的童年6.1主题派对	派对聚会	None
泥与爱情的碰撞 陶艺古法拉坯烧制	DIY手作	None
夏至时光・花园里的秘密活动	DIY手作	None
荷苗小剧场5月经典剧目《三只小猪》	暂不开放	None
大型实景互动体验之《触电・鬼吹灯》	派对聚会	None
墨门CAT演讲大会--工匠精神-一双有温度的筷子	文艺生活	None
只为你的吉他着迷：「独奏」一个古典弦琴世界	文艺生活	None
我们只提供邂逅	派对聚会	None
当520邂逅【12点见】，奉上拉菲遇见爱	派对聚会	None
高山流水遇伯牙 | 古风唯爱古琴	文艺生活	None
国庆假期《当众讲话与演讲口才》训练营	沙龙学堂	None
春风十里，不如一副雅韵亲笔	DIY手作	None
左邻右舍|油画教室：走进艺术殿堂，零基础油画体验	文艺生活	None
咚次嗒次―― 广州吉他联盟带你学架子鼓	文艺生活	None
漳州火山岛一日游(纯玩)	户外活动	None
南京 CityWalks | 梦回金陵关，寻觅那些旧时光里的风花雪月……	户外活动	None
密室脱单 ☆ 紧张刺激中触摸Ta的心跳	派对聚会	None
仙乐飘飘浪漫爱情音乐派对	派对聚会	None
【ME绘手工】瓷盘DIY ――给餐桌加点萌料	文艺生活	None
【5月8日水彩康乃馨】送上母亲节最走心的礼物	DIY手作	None
广州吉他联盟一起快乐学吉他	文艺生活	None
原创实验戏剧作品《呐   》	文艺生活	None
周易小成图预测学习 | 一命二运三风水，四积功德五读书	沙龙学堂	None
【零基础体验课】感受油画涂鸦的乐趣	文艺生活	None
走 ！！！打高尔夫球去。	运动健身	None
石林峡-挑战世界第一悬空钛合金飞碟玻璃UFO”观景台【宇宙之眼】	户外活动	None
墨香清扬 纸上生花	文艺生活	None
【听心坊皮具手作课】之眼镜盒、零钱包、卡套、钱包	户外活动	None
改变自己-潜意识沙龙	沙龙学堂	None
【树舍出品】21天 与更平静美好的你相遇-情绪管理与有效沟通	沙龙学堂	None
手作兔子 | 逗比兔胸针/包挂	DIY手作	None
来玩你从来没有玩过的剧场游戏	派对聚会	None
音乐浪漫爱情喜剧《如果・我不是我》	文艺生活	None
做一件阳光的事情：括苍山星空篝火露营大风车，流星雨中等日出	户外活动	None
光棍节专场，初冬之恋?非沪籍+白领，精品单身派对	派对聚会	None
《那年我学开车》・洛丽塔的隐秘青春（18岁以下禁入）	暂不开放	None
【行者无疆】5.8 春光无限好，去桐洲春游动手做饭	户外活动	None
自助绘画DIY油画	DIY手作	None
把你的画变成精致的耳钉、胸针、领针、袖扣吧！	DIY手作	None
【母亲节】永不凋零的爱：亲手为妈妈制作永生花	DIY手作	None
旋转木头，飞扬想象力---木工车旋体验课	DIY手作	None
经典励志喜剧《拼死为出位》	暂不开放	None
在野成人零基础油画班	文艺生活	None
现在出发，从最美乡村香屯到水泉沟徒步之旅！	户外活动	None
【孟屯河谷2日】露营 真正的贴近于大自然	户外活动	None
【中秋节】 桂林阳朔”游漓江，西街泡吧3天2晚	户外活动	None
中秋节  西冲海边露营+烧烤+环海单车休闲二日游	户外活动	None
射庐箭道―跟我玩箭”射箭体验	运动健身	None
实现从小的高尔夫梦	运动健身	None
吉他、非洲鼓系统优惠课程	文艺生活	None
纵马坝上草原・游大汉行宫・ 闪电湖・龙头山	户外活动	None
精致的生活需要这样的木器相伴|书店里的木作体验	DIY手作	None
【五一2日游】背上行囊去内心向往的地方，初夏遇见海岛	户外活动	None
So Wining So Cafe 试酒会！九款特调酒等你来	派对聚会	None
木镯雅致，腕间生香	DIY手作	None
【中秋专题】9.16  泛舟富春江之上，身临富春山居中，新桐皮划艇探索之旅	户外活动	None
"彩铅画初级教程之\""了解透视原理\""|冷饮主题日"	文艺生活	None
体验韩式汗蒸、面部水润spa、让肌肤更富有活力	运动健身	None
如烟花般绚丽，创意烟花波板糖DIY	DIY手作	None
入门级经典――徽杭古道轻松徒步	户外活动	None
手工木勺，让食物变得更美味	DIY手作	None
4种口味牛轧糖，一次搞定！手工牛轧糖DIY	DIY手作	None
茶会测试	茶会雅集	None
CityWalks  七分之五的爱	户外活动	None
凝神静气・焚香抄经	文艺生活	None
爱上海?实名单身&精品派对	派对聚会	None
零基础油画风景画或自画像	文艺生活	None
魅力女性形象设计沙龙	讲座沙龙	None
【每周五】Zumba健身-专业持证外教	运动健身	None
【端午假期】 观龙脊梯田、游阳朔山水	户外活动	None
【树舍出品】零基础油画课	文艺生活	None
龟龄岛露营 看醉美日出日落 守候星空美景	户外活动	None
颜时代制服诱惑”派对	派对聚会	None
左邻右舍|因语言而相聚：周二英语角	派对聚会	None
【登四姑娘山二峰5日】体验5000米的雪山攀登 山峰美丽壮观	户外活动	None
给你的手机一个座驾----木艺手机支架	DIY手作	None
高铁 天天出发  桂林阳朔 兴坪漓江休闲团	户外活动	None
【若尔盖】周五早7点出发 花湖湿地 红原大草原 唐克 甘堡藏寨	户外活动	None
罐头无国界市集×中骏世界城	文艺生活	None
用美好心情 亲手制作茶杯包	DIY手作	None
穷逼俱乐部【南水北蕉】专场演出无耻售票中・・・	暂不开放	None
成人零基础服装缝纫课 周末班?日常班	DIY手作	None
【端午假期】江南水乡杭州西湖-西塘-乌镇-巴士纯玩品质四星	户外活动	None
春暖・茶・山之天台山云雾茶禅修游学	茶会雅集	None
消灭疯狂保龄球	运动健身	None
到贡嘎别总是自驾，带上山地车去越野吧	户外活动	None
叮当猫奇遇记，来做一只皮铃铛吧	DIY手作	None
它现在这么火，你居然还不造？！	DIY	None
南京最美乡村黄龙岘户外露营主题活动	派对聚会	None
棍哥吉他快乐小教室	文艺生活	None
【中秋节】大巴团 乐游张家界 ：敢不敢去走天门山玻璃栈道	户外活动	None
做一个有感情的钱夹	DIY手作	None
2016魔都最夯VR主题乐园劲爆来袭! Let's Boom House!	派对聚会	None
剑道---体会一击必杀的速度	运动健身	None
【土火之艺】体验陶瓷里的慢时光	DIY手作	None
阳澄湖度假旅游区一日游 烧烤+游戏	户外活动	None
旅游交友?第15届粤港万人相亲会?爱如夏花（广州）	派对聚会	None
惬意手作：蓝胖子的皮铃铛	DIY手作	None
家居花艺初级课程	沙龙学堂	None
亦可烹茶，偷得半日闲，凡艺茶课堂	茶会雅集	None
张大千再传弟子・邢老师教你画牡丹	文艺生活	None
研磨时光，让我们一起来画画吧！愣神艺术工坊伴你一起慢生活！	DIY手作	None
北京脱口秀俱乐部幽默口才与脱口秀训练沙龙	沙龙学堂	None
即兴小学|学个表演也不是要当网红	暂不开放	None
【ME绘精品】零基础油画|等你来发现	文艺生活	None
有约不来过夜半，闲敲棋子落灯花――围棋入门	文艺生活	None
夏天就是要潜水去！	运动健身	None
【小聚场烘焙教室】卡通奶油瑞士卷制作课	DIY手作	None
5/22，大型原创音乐亲子剧《木偶奇遇记》成都站首发！	戏剧	None
零基础学尤克里里 | 学会一门乐器，从此生活与音乐有关	文艺生活	None
繁花十里，亦不如你	DIY手作	None
【端午节】|鸡尾酒课堂，2小时让你成为一名调酒师	文艺生活	None
向香奈儿小姐致敬・时尚生活必备万年款小黑裙制作	DIY手作	None
亲~~图排尿需要是横图哦 爱她！就亲手为她做一份提拉米苏吧！	DIY手作	None
4月24日，我们到宜兴去，采茶，制茶，做乌米饭，修心知味...	户外活动	None
圆心里的婚纱梦 零基础水粉画―婚纱设计	文艺生活	None
10元抢票中│仙乐飘飘浪漫吉他音乐派对	暂不开放	None
固定新手班活动+每周六双打活动	运动健身	None
春日嬷嬷茶，感受真爱的心跳频率	派对聚会	None
献给热爱生活的你 |成人零基础自助绘画	文艺生活	None
4.9周六下午3点。恋之约，海归+精英?高端单身交友会	派对聚会	None
每天甜品体验课程 16种甜品任选	DIY手作	None
乐觅画室彩铅画初级速成班	文艺生活	None
调酒课堂|六大经典鸡尾酒 炫彩与甘甜背后的故事	户外活动	None
2016亚洲指弹大师卢家宏全国巡演音乐会深圳站	音乐会	None
CityWalks  最美的礼物――走遍繁华长宁	户外活动	None
成人零基础钢琴入门丨1节课就能学会1首歌/包会	文艺生活	None
一小时变厨神，经典美式西点烘焙教学	DIY	None
禅境花园，感悟心灵的宁静之旅	沙龙学堂	None
我在安溪有棵茶树----探索铁观音	茶会雅集	None
零基础油画|西班牙餐厅里画龙猫	文艺生活	None
南国摇滚话剧《Yoko Yoko花神咖啡馆》南京封箱谢幕场	暂不开放	None
金秋新玩乐，开着飞机游长城	户外活动	None
零基础 | 画一幅画，享受其中，心会得到细腻的安静。	文艺生活	None
深圳A320全真模拟机飞行体验	运动健身	None
彩绘粘土DIY | 多点色彩，多点精彩！	DIY手作	None
改编自荒诞派最著名剧作家 让・日奈《女仆》	文艺生活	None
当水果鲜花遇见蛋糕，裸蛋糕制作课邀你来创作	DIY手作	None
High翻天 | 4.9 带你装逼带你飞，开启滑翔伞+皮划艇探索之旅	户外活动	None
策马奔腾 共享人世繁华	运动健身	None
东部湾  游轮出海，沙滩BBQ  二日游	户外活动	None
乍暖还寒 风雨来袭・Rain动成都 独领风骚	暂不开放	None
银饰体验课：春暖花开的日子，来飞鸟手作坊感受指尖温度	DIY手作	None
小皮夹才是我的小情人，亲手塑造我的最爱｜皮具卡包DIY	DIY手作	None
安溪茶行：来一场亲近大自然的茶韵之旅	茶会雅集	None
15元抢票进行中│仙乐飘飘经典钢琴音乐派对	文艺生活	None
中秋/国庆 雾漫小东江 高椅岭 仰天湖大草原三日游	户外活动	None
让我用镜头记录最美的你	文艺生活	None
【踏青|赏花】寻一诗意他乡-吴家后山辛夷花轻徒2日游	户外活动	None
一起看话剧|来笑着做公益吧	文艺生活	None
对不起，我要去一息茶修，别再找我	茶会雅集	None
零基础摄影学堂 一起玩转美	文艺生活	None
周末惠州红花湖环湖骑行，走进音乐之都奥地利小镇	户外活动	None
登通天蜡烛山，寻觅高山红杜鹃	户外活动	None
新兴天露山登高，赏杜鹃花儿红	户外活动	None
相约深圳八景之首大鹏古城，杨梅坑踩单车吹海风看海景	户外活动	None
上海话专场 ☆ 心动配对派 4月3日	派对聚会	None
SO CINE   SO CAFE / 星空放映会Vol.2	文艺生活	None
聆听不一样的钢琴之旅|零基础钢琴体验	体验课	None
拯救唱歌跑调的你	文艺生活	None
菊次郎的夏天――钢琴曲梦幻之旅演奏会（厦门）	音乐会	None
做一回野孩子！攀岩，速降，溶洞探险！	户外活动	None
用塔罗牌发现你重大决策背后的潜意识原型	讲座沙龙	None
五一  体验”奥地利小镇、怡情谷温泉摄影一日游	户外活动	None
其实你也可能做到百步穿杨	运动健身	None
「土楼寻秘」：故里南靖土楼、云水谣，迷失土楼群	户外活动	None
华东的香格里拉――仙居公盂徒步，露营，篝火晚会	户外活动	None
聚会式零基础学调鸡尾酒！	派对聚会	None
岩壁上的芭蕾，扁带上的舞者，极限运动等你挑战	运动健身	None
naoki的减脂训练营，胖着玩玩就好，别胖的那么认真	运动健身	None
【清影舞室】经典爵士舞基础班，从0开始	文艺生活	None
从白纸上的空到第一根线，只需3秒丨ArtHouse手绘彩铅	文艺生活	None
[易乐木艺]创意木工DIY创作之初体验	DIY	None
单身趴之密室脱单！3.26（六）魔都 | 消失的阿尔法	派对聚会	None
用松木代替画布 | 松木绘画体验	文艺生活	None
花艺课 | 在画室里插画，以花作画	DIY	None
零基础吉他，做一个会弹唱的人	文艺生活	None
10月1-3、4-6日误入仙境雾漫小东江，行走情迷高椅岭，穿越千年西京古道	户外活动	None
一起来看《嘿，是我》！	戏剧	None
【树舍出品】小艺谈个人资产配置	沙龙学堂	None
【香蕉蘸逗伴】好玩的脱口秀，无耻售票中・・・	小型现场livehouse	None
约旦沙画瓶限时优惠体验  强力推荐! 活动时长需要补充 是否可以多人一起作画呢？	DIY手作	None
攀岩是很酷的	运动健身	None
午后轻奢Cocktail趴 唤醒春天的你	派对聚会	None
零基础学化妆，遇见更美好的自己	沙龙学堂	None
零基础花艺课---一花一世界 | 以花为载体，与内心深处的自己对话	DIY	None
深圳半天云山脊穿越，看不一样的大鹏半岛海景，觅古村落	户外活动	None
带你体验专业攀岩运动！	运动健身	None
这个场子周末有酒有民谣，还有梵高	派对聚会	None
DIY做天然健康的植物口红 | 每个女孩子的包里都要有支口红	DIY手作	None
手造饰品（堂客专场）--体验木工的乐趣	体验课	None
谁说变美只能靠化妆和整容？瑜伽也可以私人定制！	运动健身	None
话剧《童年》	戏剧	None
青和花艺	体验课	None
惠东最美狮子岛海岸线穿越，享暖暖阳光赏无敌海景	户外活动	None
【每周日】  百万葵园赏花、看小松鼠、小白鸽一日游	户外活动	None
最受欢迎的多拿滋甜甜圈定制DIY	体验课	None
晋善晋美 大成之道 亲历课文场景	户外活动	None
云上生活，边晒太阳边画画才是正经事儿	体验课	None
挑战你的极限----全天不限时攀岩体验	运动健身	None
颜值爆表又好吃的杯子蛋糕， 你也能做！（单人、双人）	DIY手作	None
一针一线的情谊---手工皮具	DIY	None
【尤克里里制作+弹唱教学】亲手打造一把浪漫的夏威夷小吉他	DIY手作	None
3月，由一个枕头引爆的。。正能量大战	运动健身	None
单身趴之心动配对！3-20（日）魔都	派对聚会	None
恋爱补习班：打破原生家庭魔咒，收获完美爱情~3.19	讲座沙龙	None
7月28日财商启蒙沙龙	派对聚会	None
【清影舞室】形体芭蕾 给您优雅气质 体验课	运动健身	None
体验《游园惊梦》到《喜羊羊与灰太狼之江南style》文化之旅！	戏剧	None
这就是神秘的海娜手绘	DIY手作	None
尔本植者 | 小安里花园派对 烧烤/披萨	派对聚会	None
3月19日真假兰若寺，上青古道觅芳踪	户外活动	None
开心麻花丨爆笑舞台剧「江湖学院」	戏剧	None
学会网球，生活美丽，身体健康	运动健身	None
【清影舞室】 如梦似幻 一舞惊鸿！中国古典舞！	运动健身	None
零基础油画课：疯狂动物绘	文艺生活	None
买一送一|爆笑音乐喜剧「爷们儿・叁」	戏剧	None
【西安瓦舍】动动手制作海底世界，植树节一起来种小盆栽~	DIY	None
「 翘臀皇后」卡戴珊最爱运动 | 普拉提空袭上海	运动健身	None
零基础油画 |在网红咖啡馆画油画，喝下午茶拍大片	DIY手作	None
茶修课程 | 辞旧来听茶 迎新学茶去	茶会雅集	None
素描体验课 | 在黑白世界里共舞	文艺生活	None
国际顶级设计展上海2016”来啦，快来看看家具中的网红	展览	None
上海最美野骑路线：让我们策马奔腾，共享人世繁华	运动健身	None
[初级班] 零钱包 质感，淌过一针一线-皮具工作坊	DIY手作	None
看一段令人捧腹奇葩爆笑的重庆之旅	暂不开放	None
采鲜茶，画水彩。2016我们一起写生吧！	户外活动	None
买一送一|开心麻花爆笑舞台剧「旋转卡门」	戏剧	None
MIRO米洛花艺沙龙-春日小花篮 0基础学插花	体验课	None
谁说我们不懂艺术？画给TA看！	派对聚会	None
CityWalks 城市旅行 遇?静安 老上海的摩登时尚	户外活动	None
周末无聊充充电，一起学日语&德语吧！	讲座沙龙	None
单身趴之真人CS！3-13（日）魔都 | 白色情人节	派对聚会	None
【红樽 - 博仕堂 X Andy Tan】博仕集结令！	派对聚会	None
学精品咖啡！任何人都可成为咖啡师	DIY手作	None
相约浪漫厦门 鼓浪屿听涛听琴	户外活动	None
开心麻花2016爆笑舞台剧《牢友记》	戏剧	None
水与彩碰撞出的美好@水彩体验	户外活动	None
把生活过成一首诗，画出你心中经典的油画	文艺生活	None
教你变成K歌高手 体验课	文艺生活	None
油画DIY | 悠闲午后，与色彩为伴。	文艺生活	None
花亦有灵，情牵吾心	DIY手作	None
手作木工-周末时光木工活	DIY手作	None
画笔下的美好时光	文艺生活	None
拉坯体验 | 感受做陶艺的个性	DIY手作	None
零基础油画 |油画+下午茶的的奇妙组合	文艺生活	None
零基础学化妆，遇见更美的自己	文艺生活	None
室外高尔夫，体会韩剧欧巴的贵族人生	运动健身	None
野外攀岩【单/双日行程任选】	户外活动	None
画一副卡通动物油画，再配一份酸奶盆栽，让大自然的香气弥漫	DIY	None
CityWalks  黄金时代 行走甜爱路 虹口记忆升级	户外活动	None
西塘轰趴，放肆玩！（一天一夜）	户外活动	None
两天一夜 | 括苍山星空夜宿，风车 ・ 日出 ・ 云海	户外活动	None
魔都 | 女神节降临之单身趴・心动配对！	派对聚会	None
一起来演微电影――演一部自己的电影	派对聚会	None
上海最火爆的超人气脱口秀――茄子脱口秀	户外活动	None
放飞童心的翅膀――亲子风筝节风筝DIY体验	运动健身	None
探索不一样的四驱――亲子路虎汽车工业体验	派对聚会	None
手工 制作 橡皮章 自画像 雕刻礼物	DIY手作	None
零基础社交油画沙龙――让生活充满可能性	文艺生活	None
【清影舞室】绝美伦巴，让你一次爱个够！	文艺生活	None
【茶道・培训】茶沁人心，雅养怡情	体验课	None
"特价|专属银饰DIY ,送给女人节的你"	DIY	None
射箭-争做神射手 体验百步穿杨	运动健身	None
最高品质脱口秀演出・幽默小区脱口秀俱乐部	暂不开放	None
【零基础彩铅】一大波萌宠向你来袭！呆萌、快到碗里来~	文艺生活	None
新月集――成匠人之美	市集	None
房车汇Mercedes-Benz―经典Live之夜，国际顶级水准的品质音乐演出及社交平台	小型现场livehouse	None
周五私房菜－－欢聚回味家的味道	派对聚会	None
有画画、美食和朋友的周末	DIY	None
【上海2016年第一次哦】2月27日糖果果经典优质单身派对	派对聚会	None
零基础击剑训练~打比赛的感觉真的太赞了！丨 2.27周六	体验课	None
【零基础油画】如何跨越时空界限与印象派的老炮儿们亲切交谈？!	文艺生活	None
2016重制话剧《红玫瑰与白玫瑰》新辰艺术中心驻演	暂不开放	None
寻找广东最美乡村，世外桃源韶关乐昌九峰花海童话世界寻梦	户外活动	None
从种子到杯子的奇妙历程（咖啡基础知识）	文艺生活	None
【书事】周六 经典书法班”招生中，可体验哦	文艺生活	None
资深咖啡大师  带你体验流行又可玩性强的爱乐压	体验课	None
元宵夜之奇遇私房菜＋包汤圆	派对聚会	None
发间的诗意 或知性或森女或可爱	DIY手作	None
49元起，唱好一点学歌！三人同行八折！！！	沙龙学堂	None
CityWalks  一起行走苏州河	户外活动	None
让自己快乐这才叫做意义--骑马畅游	户外活动	None
世界蝴蝶生态园	户外活动	None
我就是我，香味独特的芬芳”香水调配体验活动	DIY手作	None
轻抚古琴，感受古之文人雅士	文艺生活	None
"客有吹洞箫者,倚歌而和之――洞箫入门"	DIY手作	None
【闹元宵、猜灯谜】正月十五‘元宵节’浪漫单身晚宴	派对聚会	None
「单身不寂寞之元宵情人节篇」	派对聚会	None
【私人影院】视听超享受--simon盛宴	文艺生活	None
不是你的衣服不够，是你的搭配不太对！	文艺生活	None
手工皮具第五季 | 复古手环	DIY	None
做一个真皮包，长的给你，短的给我~	DIY手作	None
【树舍出品】罗老师书法班---奥克斯店	文艺生活	None
CityWalks一起行走之情迷法租界	户外活动	None
感时花溅泪，恨别鸟惊心――工笔花鸟	文艺生活	None
一起来画冬 | 零基础油画体验 | 【美院专业老师指导】	派对聚会	None
特别的情人节―银戒DIY情侣对戒/对镯	DIY	None
黑白纯粹 |  零基础学习素描 打下扎实绘画基础！	文艺生活	None
可可脂滋养抗皱眼霜，橄榄润唇膏，黄玉兰橙花美白乳液全程手工DIY	体验课	None
和一群陌生人在不知名岛屿上户外写生（速写，零基础）	户外活动	None
3小时暖心木艺，尤克里里制作+弹唱	DIY手作	None
手绘粘土――贴心礼物亲手做！	派对聚会	None
幽默小区脱口秀・ 2月19日20日・ 最高品质的中文脱口秀	戏剧	None
佛教单身?青年/大龄&交友会	派对聚会	None
周六2月20日下午国贸成熟男士百人专场	派对聚会	None
在广州学【非洲鼓】	文艺生活	None
【儿童木偶剧】《渔夫和金鱼》全城最低票价火热销售中	戏剧	None
【约锅】低温来袭，却惊现冬日火锅之魂（女剩2，男剩2）	派对聚会	None
【四姑娘山2日游】每周出发东方的阿尔卑斯 深度观山之旅	户外活动	None
英国顶级剧团，年度压轴大戏！《Missing》华丽登场	戏剧	None
香如故，古典风铃	派对聚会	None
亲子黏土画主题： 你好啊，向日葵	DIY	None
2016，最暖心的礼物-双面羊绒大衣	派对聚会	None
生活在低处 灵魂在高处 水彩纪录生活	派对聚会	None
让我们用一个慵懒的冬日描绘飞雪	派对聚会	None
【女生1元专享】情人节，要走心~	体验课	None
皮克堂|手工皮艺课程制作	DIY	None
上城区|零基础油画体验 吃喝玩乐后带走人生第一幅油画大作	派对聚会	None
『画幅油画当年货』INK零基础绘画	体验课	None
泥塑的雅致艺术・体验陶艺手作的慢时光	DIY	None
密室脱单，邂逅心跳	派对聚会	None
[潮爸，潮妈]快带上宝贝来一次脑洞大开的绘画之旅~	派对聚会	None
带上小朋友来做一个微景观世界吧	体验课	None
中山五星营地徒步，追逐五桂山最美的色彩	户外活动	None
挥动网球拍，运动也时尚	运动健身	None
贰伍零壹钱塘江畔私家午宴	DIY手作	None
小黑裙私享复古与美感同行	体验课	None
音乐在指尖，零基础小提琴一对一体验课	文艺生活	None
主题包厢观影 云乐迪私人影吧	电影	None
考拉食验室|宇宙最强约锅”召集令（剩2位女生名额）	派对聚会	None
「家具课」做件榫卯家具 ・ 与之相伴一生	DIY	None
心理占卜-塔罗牌体验活动	体验课	None
年前邂逅男神女神 红酒桌游交友狂欢	派对聚会	None
【向日葵】6月11日 绵竹年画村一日游 看年画、拍向日葵、吃新鲜生瓜子	户外活动	None
［零基础学油画］――彩绘春天	体验课	None
城市夜景刮刮画 scratch night view ――成人减压课程	派对聚会	None
CaféDating系列 | 店长特调咖啡&法国桌游的单身约会！	派对聚会	None
请你看电影啦~（免费的只有10份哦，大家赶紧入手）	电影	None
感受一回做神射手的魅力，咻~~	运动健身	None
深圳:走！打高尔夫去 赠球杆+手套+30分钟教学指导+100颗击球	运动健身	None
Me Cafe 新年咖啡拼配：将所有咖啡课程打包送给你们	派对聚会	None
2016喜迎新春手工艺体验课程-各种精美手工艺哦	体验课	None
徒步英西峰林精华环线，观胜似桂林的田间绿野	户外活动	None
与最真实的自己舞蹈――舞蹈x灵性x疗愈体验	文艺生活	None
粘土变变变―不只是孩子的玩意儿~	派对聚会	None
在风铃里写下你对TA的祝福	DIY手作	None
细节决定气质，珍珠胸针亲手做	DIY手作	None
亲手做个葫芦送福禄吧	DIY手作	None
鸡尾酒亲手调，邂逅蓝色玛格丽特与龙舌兰日出	DIY	None
【不！是你的咖啡】咖啡制作体验	文艺生活	None
易乐木艺―创意木工初体验，明星课程大集合！	体验课	None
自由古巴原创摇滚之夜 vol.9	小型现场livehouse	None
一起做陶瓷（单人、双人）三店通用	DIY手作	None
六根弦的音乐世界―可能是最适合零基础的吉他体验课	文艺生活	None
享受一个幽静的美好时光，抹茶茶道精品教学	户外活动	None
茶艺达人第一课	体验课	None
广州教你快速学会架子鼓――零基础入门	文艺生活	None
【色达+绰斯甲观音寺4日】出发朝圣之旅世界最壮观的五明佛学院	户外活动	None
最刺激的推理游戏――温暖南瓜剧情密室	派对聚会	None
开运桃、生肖猴宝，为新春添好运~	DIY	None
三选一，做陶瓷，享受欢乐与宁静（三店通用）	DIY手作	None
一起玩泥巴咯（三店通用）	DIY手作	None
【增开课】西班牙海鲜饭：不止是海鲜”饭	沙龙学堂	None
魔都最火爆的超人气脱口秀――茄子周末秀	戏剧	None
新年来唯意坊DIY银饰，送新年大礼哟！	DIY	None
【花事】池坊花道课招生中，可体验	文艺生活	None
【东篱书院】乐理知识，音乐殿堂的钥匙	沙龙学堂	None
男生给女生化妆――让男生体验下化妆的酸甜苦辣	派对聚会	None
手捏妙趣，陶艺体验--高大上的玩陶大咖！	DIY	None
南京ComicDawn03新年动漫游戏展	派对聚会	None
手工DIY零基础学习油画	DIY手作	None
【好声音】―零基础成人声乐体验课	文艺生活	None
你就是艺术”20世纪艺术界最有名的人物之一安迪・沃霍尔艺术展	展览	None
乐享高尔夫！99元送球杆+手套+30分钟教学指导+100颗击球	运动健身	None
2015乌镇戏剧节特邀剧目《孤儿》	戏剧	None
【温暖手工●尤克里里DIY】打造独一无二的夏威夷小吉他	DIY手作	None
【最美生日礼物】爱意悄悄，DIY蛋糕送给TA	DIY手作	None
《复古妆派对》圣诞篇	派对聚会	None
重走被遗忘的西京古道，追忆绵绵古时事	户外活动	None
生活有泥”真好	DIY	None
亲近高尔夫 99元赠球杆+手套+30分钟教学指导+100颗击球	运动健身	None
周末变身文艺青年，零基础变梵高	文艺生活	None
爆炸party第二波：12月26日 安吉竹海+撕名牌等欢乐小活动+温泉party	户外活动	None
走进新兴曹田香雪海，探梅花朵朵开，寻田园乡村	户外活动	None
琪敏的私房油画体验（零基础油画）	体验课	None
深圳 | 锤友汇聚Smartisan T2直播现场	派对聚会	None
【零基础 画油画】 每个人都是生活的艺术家	派对聚会	None
菊次郎的夏天――钢琴曲龙猫乐队梦幻之旅演奏会（福州）	音乐会	None
12.25周五我们一起玩穿越 | 京城圣诞复古时光旅行派对	派对聚会	None
塔罗情人牌阵：遇见爱的关系	讲座沙龙	None
零基础学画国画，喜欢你是寂静的	文艺生活	None
电光火石间的浪漫@金石篆刻初体验	DIY手作	None
阳光正好，带上你的尤克里里去旅行！	文艺生活	None
强势来袭|12月26日，幻梦之旅，魔法星空”2015年度时尚圣诞派对	派对聚会	None
放肆嗨！！吃喝玩乐一站式懒人家庭聚会趴	派对聚会	None
奥地利风情-轻奢古典乐【大提琴体验课】	文艺生活	None
《爸爸回来了》贾乃亮、甜馨疯玩的Snap！拍”圣诞特惠！	派对聚会	None
甩网红几条街的气质大提琴，女神必备！	文艺生活	None
姜饼人、圣诞树、小麋鹿、圣诞老人，快到碗里来~~	DIY	None
老洋房零基础油画买一送一！！！	文艺生活	None
幽默小区脱口秀・ 1月15日16日・ 最高品质的中文脱口秀	戏剧	None
慢下来，和心灵对画	文艺生活	None
一起来做你的专属姜饼人	DIY	None
魔都最火爆的超人气脱口秀――茄子脱口秀	戏剧	None
单反微单摄影快速入门含后期培训	体验课	None
催眠精华课：第六感与身体对话，告诉你心灵深处的答案	讲座沙龙	None
一大波活动袭来~魔术，油画，瑜伽，趴全都有	派对聚会	None
喵星人陪你一起做：霓虹国的「景泰蓝」	体验课	None
浪漫brunch，两人携手完成的一份郅蔚案	派对聚会	None
只教成年人钢琴， 零基础包会	文艺生活	None
一把刷子，一面镜子，像施了魔法一样让我们美丽起来――专业化妆体验课	文艺生活	None
创意扎染	DIY	None
用一个午后时光与自己对对画	派对聚会	None
嘿！12月31-1月2日跨年迎新看雪景，三尖送你免费玩！～	户外活动	None
国际私教面对面主题健身沙龙-快速有效的改变体型	派对聚会	None
咖啡师初体验	沙龙学堂	None
请赶上这趟音乐列车丨从零开始学吉他	文艺生活	None
360度无死角零距离欣赏这种源于欧洲的戏剧表演形式，咖啡剧《山丘》演出轰动全场！	派对聚会	None
风格温婉的茶艺课-体味茶道之美	茶会雅集	None
最高品质的中文脱口秀演出・12月11日・幽默小区脱口秀俱乐部	戏剧	None
【 零基础戏剧训练】国内咖啡戏剧第一人教你演戏，本期主题无实物打戏”学习	体验课	None
午后油画沙龙：梵高的花花世界之向日葵	派对聚会	None
《性福工作坊》第6班	购物	None
油画零基础 限时优惠体验 | 每一幅都有一个故事	DIY手作	None
还在嫌弃生活千篇一律太无聊？一起来参与一场超嗨的表演吧	派对聚会	None
火遍魔都的超人气脱口秀――茄子脱口秀	戏剧	None
蓦然回首，遇见你――沪上人气单身派对	派对聚会	None
炎炎夏日，你带上我，我带上相机，我们约拍吧~	派对聚会	None
扎染围巾 DIY专属于你自己独一无二的色彩	DIY手作	None
12/05尊享波尔多格拉芙经典――萨伊古堡红葡萄酒垂直品鉴会	派对聚会	None
MISHA【画室静静的寻找自己的艺术邂逅】零基础油画活动	文艺生活	None
声音美容，拯救五音不全的你	文艺生活	None
成为一名最具气质的古典美人――琵琶零基础	文艺生活	None
创意毕加索-儿童油画入门	文艺生活	None
唯意DIY银饰/项链订制体验课	DIY手作	None
最高品质的中文脱口秀演出・12月12日・幽默小区脱口秀俱乐部	戏剧	None
MYart零基础咖啡油画派对（福田班）	派对聚会	None
叁厘米@男闺女蜜撕奔派对夜	派对聚会	None
连州赏银杏，唱起秋天幻想曲，登绝美广东第一险峰”金子山垂直天梯	户外活动	None
我和春天有个假面舞会	派对聚会	None
赞皇棋盘山	景点	None
手冲咖啡教学-品味属于自己的咖啡	运动健身	None
只爱陌生人――爱情36问	派对聚会	None
让我们来一场高雅的德州聚会	派对聚会	None
【中秋登高】 穿越秀丽九龙峰，探秘广东畲族村落---角峰村	户外活动	None
火爆魔都的超人气脱口秀――茄子脱口秀	戏剧	None
心理研习社 | 2小时心富训练课：发现你的天赋优势	讲座沙龙	None
秋高气爽登山季，赏云髻枫叶渐红	户外活动	None
深圳最低价直升机飞行体验！再次开团！！	户外活动	None
心理研习社 我是塔罗师”私教课 | 左手是预测，右手是改变生活	讲座沙龙	None
心理研习社 我能说”高体感沙龙 | 让你自己的话打动人心提升关系	讲座沙龙	None
『大山的中文脱口秀专场』11月20日▲三里屯幽默小区荣誉出品	戏剧	None
从《天空之城》到《起风了》――久石让电影音乐30年交响视听纪念版 （深圳）	户外活动	None
中原福塔	景点	None
心静声即淡，其间无古今――古琴初级	文艺生活	None
陶艺拉坯及上釉烧制――体验土与火的艺术	DIY手作	None
每个人都是生活的艺术家――零基础绘画体验回归校园生活	派对聚会	None
【英雄帖】大型冬季户外活动――奔跑吧BOYS&GIRLS、邀你来战！	运动健身	None
11/25勃艮第产区专业讲师 齐绍仁带你喝懂Mercurey村美酒佳酿	派对聚会	None
手工皮具课：做一款复古风格牛皮钱包 沉静内敛	体验课	None
零基础尤克里里体验课，给你带来满满元气	文艺生活	None
（双十二抢票）《当金星”遇到火星”》 女性情感大讲堂	讲座沙龙	None
《海上钢琴师》现场版――天利名家浪漫之旅演奏会	暂不开放	None
心理健康占卜沙龙	讲座沙龙	None
连续6年的狂欢派对『薄若莱新酒百人开瓶激情派对』	派对聚会	None
火爆上海的超人气脱口秀――茄子脱口秀	戏剧	None
我喜欢闻牛皮的味道，你呢？亲手做一件皮具，让它陪伴一生	DIY手作	None
玩乐与寻心，与沪上最专业吉他老师一起零基础开始学吉他	文艺生活	None
环绕双月湾、大星山徒步海岸线，与巨石来一场约会	户外活动	None
最美不过工笔画 | 丹青写出与君看（淮海馆）	文艺生活	None
英德九洲驿站徒步、浸泡树上温泉、岭南第一洞天宝晶宫奇观	户外活动	None
Warehouse11.11快速约会征集男女嘉宾	派对聚会	None
[轻旅行] 最厦门-Citywalk：一起来以最独特的方式体验最地道的厦门	户外活动	None
成人钢琴速成，小资的音乐部落~~	文艺生活	None
《阿克西姆魔镇》，带你领略新派神话的巅峰之作！	派对聚会	None
心理研习社 如何快创”你的高体感	讲座沙龙	None
手工皮具特惠！――亲手做一件奢侈品！	DIY手作	None
《卡坦岛》让你在游戏中学习成为谈判高手	派对聚会	None
塔罗牌阵：心之所愿，洞见未来事件	沙龙学堂	None
笔下的故事----零基础油画	派对聚会	None
享受幽静时光，抹茶茶道精品教学	茶会雅集	None
侦探主题游戏 《犯罪现场》 | 与身边的福尔摩斯一较高下！	派对聚会	None
【新年新高度】勇攀广州第一峰，天堂顶海拔1228米	运动健身	None
你我他-人际关系心理小组招募	体验课	None
【我图电影院】11月刊卷首语：还是要相信爱情啊 混蛋	电影	None
自己做个多啦A梦的皮铃铛吧！	派对聚会	None
心动微约会-单身配对Party	派对聚会	None
[限时优惠] 邂逅莫奈的秘密花园 #零基础油画体验课程#	文艺生活	None
超爆笑茄子脱口秀―让你欢乐一整晚，还有超值双人票等你来抢啦！	戏剧	None
圣诞节狂欢夜的开始・上海欢乐谷	派对聚会	None
用沙梳理你的心事|生活中的心理学	沙龙学堂	None
百步穿杨?一箭倾心，约约约……	派对聚会	None
千与千寻――久石让?宫崎骏动漫原声视听大型交响音乐会（深圳）	音乐会	None
"10月31日，百人万圣狂欢Party,一起来鬼混，够胆你就来！"	派对聚会	None
零基础两课时 中幅画框 油画体验 | 仰望梵高的孤寂星空	文艺生活	None
陶艺拉坯+上釉+烧制限时大优惠！！	DIY手作	None
金钱无法衡量的才称为礼物！做一支独一无二的红木钢笔	DIY手作	None
零负担夏季穿搭美人―私人形象顾问带你玩转服装搭配＆衣橱管理	沙龙学堂	None
惊险刺激的枪战体验|僵尸王之战2-卡戎手环（Advance Preview）	派对聚会	None
经典裸蛋糕一对一入门课程	DIY手作	None
来武汉最具艺术情怀的陶艺体验馆，零基础学做陶―拉坯、上釉、烧窑	派对聚会	None
千与千寻――久石让?宫崎骏动漫原声视听大型交响音乐会（上海）	暂不开放	None
【中秋｜牛背山2.5日游】徒步云海之巅 天空之城	户外活动	None
北京文化游（第二期）：《穿越明清入北京，一入侯门深似海》	户外活动	None
【此场已售罄！需要的可购买周五场】『大山的中文脱口秀专场』11月21日▲三里屯幽默小区脱口秀荣誉出品	戏剧	None
用画笔观照另一个自己---零基础油画	派对聚会	None
潮爆朋友圈的潮流新F配，Chan luu手DIYn程	DIY手作	None
单身白领心动配对Party	派对聚会	None
年轻单身狗的约饭交友趴	派对聚会	None
拿起吉他忘掉抑郁，解压零基础吉他体验课	文艺生活	None
太湖湿地芦苇荡品大蟹，同里古镇闲散寻宝”一日游!	户外活动	None
理财桌游，两小时游戏演绎人生四十年	派对聚会	None
秋游去！云蒙山登高――赏秋景，摘野果，云蒙山一日游	派对聚会	None
沪上超人气爆笑脱口秀――茄子脱口秀，两人同行更优惠！	戏剧	None
王老师的摄影初级后期课	体验课	None
静下心来，一起体验陶艺漫生活	DIY手作	None
首饰DIY-锻造纯银对戒/手镯	DIY手作	None
Fun Job | 零基础绘画体验 | 专业老师指导	DIY手作	None
你了解自己的声音吗？来上流行声乐体验课吧	暂不开放	None
一叶知秋 做一把绿泥紫砂壶吧	派对聚会	None
一起来画秋” | 零基础油画体验 | 【美院专业老师指导】	体验课	None
10.11周日，徒步千年唐官道，赏东坪古村秋色，采摘火红柿子	户外活动	None
秋意浓”零基础小提琴体验课，当一个爱生活的音乐诗人”	文艺生活	None
用树脂定格时间 | 手工树脂押花手镯、戒指	DIY手作	None
「木梳子」制作一把木梳，让它陪伴发丝一生	DIY手作	None
云谣君私塾：掌握恋爱技巧，爱情手到擒来永不过期	派对聚会	None
用树脂封存绽放的瞬间 | 手工押花项链	DIY手作	None
亲手做一把只属于自己的紫砂壶  第二季	派对聚会	None
小文艺遇见小卡包，手缝制作体验慢生活	DIY手作	None
【重返17岁】回归校园，高庙古镇寻宝3日之旅	运动健身	None
亲手做一条真皮皮带送给粑粑	DIY手作	None
【10.25周日】逛&吃~逛&吃~周周美食 厨艺大会来啦！	派对聚会	None
怪石嶙峋，穿越十门九不关雄伟石门群，登顶搁船尖，草甸巍峨！	运动健身	None
躺在长城上数星星，桨声灯影夜游古镇：玩透古北漫游季	派对聚会	None
拥有一场专属『我们』的电影	电影	None
徒步丹霞锦江，赏秀美丹霞，访牛鼻古村，登丹霞最高峰―巴寨	户外活动	None
圣索菲亚教堂	景点	None
零基础油画：画笔下的故事	派对聚会	None
【宠物游报名】别只计划你的十一旅行，留一天陪狗狗赏花烧烤拍写真去	派对聚会	None
POPO KIDS CARNIVAL飞来的乐园・泡泡嘉年华 厦门站	派对聚会	None
不一样的吉他----尤克里里0基础体验课	派对聚会	None
花课程|定格瞬间美好手作女神范永生花包包 、永生花手机壳・・	户外活动	None
厦门钟鼓索道	景点	None
【爆笑魔脱】――茄子脱口秀特别场，当魔术遇上脱口秀	戏剧	None
情感沙龙 | 你这么可爱，可惜不会谈恋爱	沙龙学堂	None
「阿加莎克里斯蒂来到2034！」南国剧社「东方快车」青春剧场公演场	戏剧	None
一起任性DIY永生花	派对聚会	None
你的个性定制――银手镯DIY体验	DIY手作	None
9月26日 周六 徒步吴越古道，攻占千顷关，浙西天池摘山楂	运动健身	None
幽默小区脱口秀出品：挑战麦克风（3月12日）	戏剧	None
【醉过】逼格速成――红酒初级课	派对聚会	None
沙发畅聊派Sofa free talker 中英双语畅聊	派对聚会	None
恐怖灵异主题游戏：《阿克西姆魔镇》	派对聚会	None
十一欢乐行 堆与绣的结合-堆绣	体验课	None
我是裙子控-2016年成人零基础裙装缝纫课程	DIY	None
闲适的周末｜自助绘画走起！！	文艺生活	None
9月19古老的绕线首饰工艺体验（做绕线戒指、手链、耳环）	体验课	None
秋游去！寻着苍老师的足迹爬长城――慕田峪红螺寺1日游	运动健身	None
首饰DIY-雕蜡版制作银戒指	DIY手作	None
Party Time！海滩BBQ趴，浪漫烟花趴，游轮趴，海上KTV	派对聚会	None
【画事】尝试做那些你不会，但美好的小事――零基础油画体验	文艺生活	None
《海上钢琴师》现场版――经典电影钢琴曲天利名家浪漫之旅演奏会（南京）	暂不开放	None
我们准备好了浩瀚的银河”，等你来初台”！	派对聚会	None
【国庆特辑】假期别再宅着了，一起去体验原生态美！	派对聚会	None
老洋房浪漫双人油画	DIY手作	None
手工制作捕梦网	派对聚会	None
从《天空之城》到《起风了》――久石让电影音乐30年交响视听纪念版 （上海）	暂不开放	None
1节课教会你吉他弹唱五月天《拥抱》	文艺生活	None
成就事件测评：找到你的职业优势和甜点”(好友同行9.9元)	讲座沙龙	None
今年，全城最有taste、最神秘、最走心的中秋礼物将空降来临。	派对聚会	None
幽默小区脱口秀・ 10月10日/三里屯老书虫书吧（中国最高品质脱口秀喜剧演出）	戏剧	None
攀岩，速降，探险”的极度疯狂！住宿升级哦！	运动健身	None
千与千寻――久石让?宫崎骏动漫原声视听大型交响音乐会（北京）	暂不开放	None
小提琴不是摆个POSE就叫帅，老干部召唤你来小提琴体验课啦	派对聚会	None
9月13日 昱岭关-搁船尖，徽浙之间最后的山越秘境	运动健身	None
Ours外语社日语、德语零基础班招生啦！	派对聚会	None
「就要不一样」亲手DIY画一个帆布包！零基础绘画体验	DIY手作	None
「布衣乐队」 20 周年全国巡演第二轮	暂不开放	None
「限量爆笑，手慢无」火爆魔都、女人必看的爆笑脱口秀剧―《渣男启示录》再度来袭	戏剧	None
完美世界”―金玟岐2015首唱巡回音乐会 ・成都站	暂不开放	None
「林雨阁」鉴宝，教你如何成为一个收藏家	沙龙学堂	None
「仅限30个双人优惠名额，快来抢票！」Fun Knights放游族?鹦鹉螺市集 ――城会玩大派对	派对聚会	None
特e的花送o特e的你 | 永生花玻璃房n程	DIY手作	None
云谣君私塾：凝气为质	派对聚会	None
妙语中秋「金星脱口秀」沈阳站	戏剧	None
陶艺DIY，泥巴玩起来	DIY手作	None
「故事来自手工」秋天来啦~还不动手做做自己喜欢的物件么？	派对聚会	None
朝歌全明星室内乐团：「Interstellar」音乐大乱斗音乐会	暂不开放	None
发现王国	景点	None
【零基础 画油画】	文艺生活	None
潜意识之海：通过心理游戏洞见你的人际互动模式	讲座沙龙	None
中秋在即，冰皮Q弹月饼自己做	派对聚会	None
「袖珍的园艺」萌萌多肉带回家	DIY	None
英西峰林走廊徒步，探索神秘千年瑶寨，瑶族篝火晚会	户外活动	None
零基础画油画，静中观物动，闲里看人忙	派对聚会	None
敢不敢飞上来？！	运动健身	None
袜子娃娃――致后来的我们，后童年的诗歌	派对聚会	None
笑乐汇金秋九月”相声专场，郭德纲徒弟高鹤彩领衔主演	戏剧	None
DIY一串手链，戴出的是自己的感觉	派对聚会	None
THE BOND 艺术音乐节！！山海间的游乐场，让耳朵怀孕的音乐场！	派对聚会	None
心理研习社| 从你的身体发现亲密关系真相	讲座沙龙	None
我，听着你的故事--倾诉”心理沙龙	派对聚会	None
超人气爆笑脱口秀――茄子脱口秀，两人同行更优惠！	戏剧	None
【蔚蓝大海】9.3-9.4鹤浦岛黄金沙滩，捡贝壳、烧烤，水晶葡萄采摘	运动健身	None
这个秋天，是不是该换个文艺范儿，来给自己量身定制把，给自己做条扎染围巾~	派对聚会	None
在魔都看「夏洛特烦恼」：假若人生能够重来	戏剧	None
重返徽商之路，轻装穿越徽杭古道，一天行！	运动健身	None
"今夏京城最后一个\""高颜值\""户外泳池派对 | 预售票已售罄，最新派对信息！！"	派对聚会	None
"【享悦酒庄游】 亲历葡萄酒诞生”,检验你脑补能力的时刻到了！"	派对聚会	None
纸花儿Diy2：生活如此美好，手工如此简单	派对聚会	None
开心麻花 | 爆笑音乐剧「爷们儿・叁」（A区即将售罄）	戏剧	None
从临摹大师作品开始作画	派对聚会	None
[PainterGo]光谷zoo coffee 零基础约画《一叶百帆》《普罗旺斯》二选一，送33元以内饮品哦！	文艺生活	None
马E 孤鸟的歌” 系列音乐会―重庆站（电子票）	暂不开放	None
2015林俊杰「时线 ・ 新地球」世界巡回演唱会成都站	暂不开放	None
你的个性定制――银戒DIY体验（单人、情侣、闺蜜）	DIY手作	None
我把四季用来等你―吴冠中的风景世界	DIY	None
【育泰击剑】达人带你玩――击剑（周六满）	运动健身	None
"唯有美食与心灵不可负，与弗洛伊德一起学做披萨,烤羊腿,捕梦解梦。"	派对聚会	None
漫步英西峰林，胜似桂林阳朔，观山间绿野蓝天白云	户外活动	None
不是草莓，不是迷笛，是橘子洲！2015橘子洲长沙音乐节来啦！	暂不开放	None
三人行，一人免费，一起来happy!	派对聚会	None
幽默一把~，看中国最高品质脱口秀喜剧演出，名额有限，速速开抢~	戏剧	None
「新技能DIY之精油」芳疗师傅说，每个人都有自己的味道，而这里可以作出你的味道	派对聚会	None
笑乐汇相声，郭德纲徒弟高鹤彩带你嗨翻全场！	戏剧	None
享受一个幽静的下午，抹茶茶道精品教学	派对聚会	None
2015 爵士即兴音乐节，五城同行深圳站	暂不开放	None
小小驯犬师，与狗狗的一次亲密接触	派对聚会	None
麦霸养成记！声乐训练体验课，拯救五音不全的你！	文艺生活	None
回归最初的自然，手工制作研磨皂	派对聚会	None
「最绚烂的花，在战场怒放」英国空动剧团《战火玫瑰》杭州站	戏剧	None
圆你开店的梦想――咖啡DIY	DIY手作	None
「木戒指」做一枚木戒指，刻录美好的时光	DIY手作	None
维也纳童声合唱团音乐会	暂不开放	None
杭城新爸妈看过来！宝宝驾到－名医荟萃－育儿大讲堂，开课啦～	派对聚会	None
用最轻松的方法弹出最自由的音符	暂不开放	None
带着手机撞见生活的小美好～	派对聚会	None
「木领结」时尚达人，必不可少的木制单品	DIY手作	None
手工皮具第二季 | 原色植鞣皮简约短钱包	派对聚会	None
琴弦上的世界--黛西?乔普林小提琴音乐会	暂不开放	None
特别策划 | 狂欢东海音乐节，在音乐中解放你的身体	派对聚会	None
朱家尖浪漫沙滩游，住泥巴旅舍，跟狗狗一起留下爱的爪印	派对聚会	None
清雅之旅――赏红叶松坪沟徒步健行	户外活动	None
无可抵挡的浪漫诱惑 ・ 「少女酥胸」法式马卡龙DIY	DIY手作	None
上海大观园	景点	None
「主题手作聚会」 纸花艺，片刻组成永恒	派对聚会	None
跟小懒一起画油画・梵高《杏花》&《雏菊与野罂粟》	派对聚会	None
大落差、大风景、大刺激「桐庐大溪峡」你敢来我们就敢约	运动健身	None
马E 孤鸟的歌” 系列音乐会―长沙站	暂不开放	None
瑞典民谣精灵Sophie Zelmani中国巡演成都站（票售罄请勿下单）	暂不开放	None
体验另一种生活方式，一站式自助画室~	派对聚会	None
给自己或给TA，制作一个简约短钱夹	派对聚会	None
装在瓶子里的属于我们的爱	派对聚会	None
七夕装bigger”约会套餐~~承诺戒指，缠绵手绳，誓言青瓷板	派对聚会	None
「故事来自手工」带上那个他，她，他们一起来玩手工吧	派对聚会	None
这周，我和自己有个约会――独处心理沙龙	派对聚会	None
38元教你弹会2首曲子，完成你的钢琴梦想	暂不开放	None
《沧海一生笑》常宝华先生从艺八十周年巅峰演出	戏剧	None
你有一所房子，面朝大海，春暖花开	派对聚会	None
与油画来一场亲密接触	文艺生活	None
「秋日私语」―小野丽莎2015中国巡演成都站（A区已售罄）	暂不开放	None
用一部电影的时光，换一段美好的回忆！	派对聚会	None
【菲林私人影院】1个浪漫的环境，6个人的狂欢聚集地	电影	None
【限时特惠】帅到没朋友｜中国传统箭术、猎术体验	运动健身	None
天空之城｜久石让・宫崎骏动漫作品视听音乐会-济南站	暂不开放	None
【永生花任性DIY】让小王子燃烧自己回到玫瑰身边	派对聚会	None
粑粑麻麻！我要去富力空港假日酒店当总经理！您俩来见证！	派对聚会	None
羊毛毡戳戳乐o(*RQ)ツ做多少带多少走~	派对聚会	None
「幽默小区」美术馆后街77文创园：中国最棒的脱口秀喜剧现场演出	戏剧	None
暖爱画艺	派对聚会	None
成长，成为自己想要的样子---沙盘小组招募	讲座沙龙	None
现场版奇葩说，用思想对话+结交走心的朋友+单身party（欢迎外国朋友，可双语）	派对聚会	None
天空之城-久石让×宫崎骏动漫视听音乐会（预售中~）	暂不开放	None
零基础玩转绘画，还有小猫玩耍	DIY	None
浪漫双人陶艺――演绎人鬼情未了的浪漫故事	派对聚会	None
【滨海狂欢】海滩露营+水上撕名牌+最美日出+快艇上岛	派对聚会	None
永生花首饰diy|用一朵小花抓住夏天的尾巴，记录今夏难忘的回忆	派对聚会	None
双人套票・开心麻花|《羞羞的铁拳》击中的是谁的心？	派对聚会	None
来paintibox，给自己选一幅画	派对聚会	None
吃茶、画画、谈天	DIY	None
敢爱来表白！杭城最具逼格七夕礼物在这里！	派对聚会	None
等风来的日子，你想好和谁一起体验尤克里里了吗？	文艺生活	None
陈珊妮「如同悲伤被下载了两次」2015巡回演唱会	暂不开放	None
这个秋天，让吉他与你相约	文艺生活	None
肖邦传奇｜李云迪世界巡演	暂不开放	None
「脱单行动」周六晚假面单身派对	派对聚会	None
袜子娃娃：致后来的我们，后童年的诗歌	派对聚会	None
【N・A】以书为媒	派对聚会	None
爆笑茄子脱口秀―让你欢乐一整晚，还有超值双人票等你来抢啦！	戏剧	None
刻在石头上的中国字――篆刻艺术体验活动	派对聚会	None
「周日永生花DIY体验沙龙」七夕只为解相思 请约你的女神一起来	派对聚会	None
立的画架，手执画笔 | 画出笔下的故事	派对聚会	None
只想逗你莞尔一笑 | 经典爆笑喜剧「夏洛特烦恼」	派对聚会	None
还窝在家？NO！快来音乐室体验一把歌手的感觉	暂不开放	None
混合酷炫灯光和动感音乐，high翻荧光跑道！Electric RUN热波电跑，酷炫狂拽耪ㄌ欤	运动健身	None
8月22-23日经典楠溪江水线穿越	商业	None
日本指弹大师岸部真明，2015年金秋巡演-杭州站	暂不开放	None
「奔跑吧，兄弟们」来尝尝撕名牌的快感！	户外活动	None
健身教练为你私人订制，我要的不是瘦而是线条！	运动健身	None
9月20玩味鉴赏琥珀，做一次琥珀首饰匠人	派对聚会	None
亲手做一束纸艺玫瑰，让爱永不凋零	派对聚会	None
【最低价格】80分钟极致体验，玩转最高端帆船运动	运动健身	None
潮人，一起来做一款复古挂件/项链	派对聚会	None
「完美世界」金玟岐首唱巡回音乐会 | 十年幕后 一鸣惊人	暂不开放	None
大河之舞2《舞起狂澜》南京站	暂不开放	None
与沪上最专业指弹老师约一堂零基础吉他体验课	暂不开放	None
美食搭配上亲手做的好看餐具，味道会更美哦	DIY手作	None
「从来未有重逢，只因未曾分开」 仙剑奇侠传舞台剧成都开演（A、B区售罄）	戏剧	None
轰趴要不要？松江田园风千平花园别墅	商业	None
咖啡师体验精品活动	派对聚会	None
成人零基础钢琴体验：做大艺术家，任何时候都不晚	文艺生活	None
木戒 木镯 木簪。打磨一段时光赠与你	派对聚会	None
北方明珠白洋淀荷花大观园休闲一日游！	户外活动	None
六种瑜伽体验・ 总有一种适合现在的你	运动健身	None
你静心画一幅画，我们送你一杯法式红酒	派对聚会	None
《小森林・冬春篇》：让人眼馋的西红柿罐头拌意面	电影	None
扎染：关于颜色的奇妙之旅	派对聚会	None
【搬家啦~~】静如处子，动如脱兔 | 感受射箭之美	运动健身	None
【蝴蝶谷泡潭】享受夏日清凉 抓住炎热天气的尾巴	派对聚会	None
我们离阅读只差一份安静：Me Cafe 无声读书会	电影	None
无限盛夏音乐节：音乐，恋爱，打碟，玩水，狂欢，ROCK！！！！	暂不开放	None
驰骋醉美草原，广东武功山”――罗定八排山花海云海排山倒海	户外活动	None
手把手教你DIY治愈系卡通动物饼干＆曲奇	DIY手作	None
『幽默小区望京首秀』国内最高品质的中文喜剧脱口秀演出！经常有神秘大咖登台表演哦！	戏剧	None
狮子岛烧烤露营放风筝，烟火孔明灯狂欢夜，双月湾出海捕鱼	户外活动	None
「美周六」沪上超人气脱口秀・茄子再出击 ― 让你欢笑一整晚	戏剧	None
双人套票 ・「夏洛特烦恼」：假若人生能够重来	戏剧	None
「育泰击剑」击剑――离你并不遥远！	运动健身	None
Brunch With U”预订你的七夕盛宴：饮食男女，谈情吃饭（仅限单身）	派对聚会	None
皮娃娃创作：以爱为名，将所有的荒诞不羁，童真可爱交给双手去完成	派对聚会	None
轰趴场馆最佳选择	派对聚会	None
「看看」世界 莫文蔚世界巡回演唱会	暂不开放	None
做韩剧/TVB主角，时尚「壁球」体验（每周日预约，尽情发泄）	运动健身	None
马E「孤鸟的歌」全国巡回音乐会 ・ 重庆（只有C区D区咯）	暂不开放	None
【超值体验】请客吃饭 不如请客留汗	运动健身	None
【醉过】夏日Cocktail！业余调酒师养成记	派对聚会	None
留住好梦与祝福：为Ta 亲手做个捕梦网	DIY手作	None
「优惠」零基础油画：艺术让你的生活更多彩！	派对聚会	None
世界十大最美书店，国内最高品质的中文喜剧脱口秀演出！黄西、崔永元、大山都经常来这里表演哦！	戏剧	None
【吃过】吃私厨料理的正宗日本海鳗鳗鱼饭，看电影《深夜食堂》	DIY手作	None
清远观音山，秀美小九寨”，嬉戏纯美溪水，畅游夏日	户外活动	None
敢挑战你的肾上腺激素吗？ Legend Puzzle真人密室逃脱	派对聚会	None
回归最初的自然 | 手制精油香皂	派对聚会	None
文艺地玩「泥」， 感受陶艺里的慢时光	户外活动	None
向大师靠拢，文艺女子必get技能，莫奈《睡莲》画画画	派对聚会	None
开心麻花《羞羞的铁拳》爱情里的喜剧人生	戏剧	None
探寻户外岭先运动・首届凤凰岭户外运动大会，来过可能就惦记一辈子！	运动健身	None
淡淡木质清香，个性书签DIY~	DIY	None
爆笑喜剧登陆魔都 | 开心麻花「乌龙山伯爵」	戏剧	None
马E「孤鸟的歌」全国巡回音乐会・成都（纸质票，D区即将售罄）	暂不开放	None
色彩玩家 | 手绘你的专属T恤、衬衫、鸭舌帽、帆布包、帆布鞋	文艺生活	None
一个夏日午后，画一幅自己的名画	派对聚会	None
画一出你指尖的禅绕画	派对聚会	None
「两人便开课」活泼的乌克丽丽弹出U型的微笑~	暂不开放	None
做自己的小太阳：剪裁DIY「太阳裙」	派对聚会	None
吃私厨料理的正宗日本鳗鱼饭，看电影版《深夜食堂》	DIY手作	None
「奥斯卡之夜」法国Amon弦乐四重奏音乐会―杭州站	暂不开放	None
亚洲青年管弦乐团交响音乐会	暂不开放	None
周末户外出行，就让云朵伴你同行！	派对聚会	None
十渡孤山寨「竹筏」「漂流」「美食分享」，美女湿身大作战！	户外活动	None
做自己的摄影师，就在等待的时光自拍馆~（预订有优惠哦）	派对聚会	None
徒步穿越原始森林公园，崇州鸡冠山	户外活动	None
【笑过】「美周六」爆笑茄子之夜 ・ 沪上超人气脱口秀（两人同行更优惠噢~）	戏剧	None
涂色，「秘密花园」里的秘密	派对聚会	None
带着温度的礼物 ― 零基础手工皮带制作	派对聚会	None
拨开葡萄酒神秘面纱，葡萄酒达人培训课程。	派对聚会	None
有奖活动|玩转互联网教育社交：对热爱的事业，锱铢必较	派对聚会	None
一起来做软陶吧！软陶听得懂你的话～	派对聚会	None
双人套票| 开心麻花「乌龙山伯爵」，邀你看戏，买一赠一（售空）	派对聚会	None
陪你一起拉响大提琴，是我能想到最浪漫的事	暂不开放	None
「孤鸟的歌」2015马E南京演唱会	暂不开放	None
千与千寻|宫崎骏久石让动漫视听音乐会	暂不开放	None
寻找安静，来「午后自助画吧」放松心灵释放压力	派对聚会	None
【美过】再贵的面膜也不如自己亲手调制的安全 ・ 名贵精油+精致下午餐+懂护肤的一群人，夏天该有好气色~	派对聚会	None
七夕特供 ・ 桃心画框 | 你左 ・ 我右  把我们的时光，都画在这里	派对聚会	None
「零基础学绘画」今天约画吗？绘画体验课来啦~	派对聚会	None
还在玩「壁咚」？快来打「壁球」啦！（每周六有指导新手活动）	运动健身	None
夏天，从一次漂流开始――「川西第一漂」开耍！	户外活动	None
「北京最烧脑」恋战伊甸园”主题嘉年华夏日狂欢等你来战！！！	户外活动	None
与木为友，当个快乐的小木匠~	派对聚会	None
零基础油画DIY体验	派对聚会	None
周末秘密花园见……约吗？	派对聚会	None
10月29日【高山草甸】走进神秘那吉石头村，探访广东最美高山草甸龙头岭	户外活动	None
逢简水乡闲逛尝美食坐乌篷船，观清晖园，品岭南水乡文化	户外活动	None
特价轻户外| 花开半夏，来北京「最美空中草甸」百花山上拍美照~	派对聚会	None
牛背山越野车+徒步冰雪之旅	户外活动	None
教你如何演讲  每周四 一起来练习演讲	沙龙学堂	None
健身课程 | 私人教练为你量身订制，快来练出马甲线！	运动健身	None
限时冰点体验价|最特别的礼物送给你：制作一个捕梦网，让好梦顺着羽毛流下~	派对聚会	None
Linkin Park林肯公园演唱会重庆站	暂不开放	None
抉择轰趴馆	派对聚会	None
灵动的沙画，一掬细沙、一双妙手创造世界	派对聚会	None
禅绕画：让自己的大脑做个瑜伽	派对聚会	None
当季热门|紫海香堤赏薰衣草，古北水镇探索胡巴的魔法世界，融入跑男欢乐的世界！	派对聚会	None
如果你总是有一个不会拍照的朋友~那么跟我来自拍吧	派对聚会	None
张靓颖「BANG The World」巡回演唱会，成都站！	暂不开放	None
千与千寻久石让・ 宫崎骏动漫视听音乐会	暂不开放	None
【小憩推荐】品一杯咖啡，还有猫咪温柔的陪伴	文艺生活	None
「燕尾榫」榫卯进阶课 ・为喜爱木头天然材质的你准备	DIY	None
你不能拒绝浪漫：十渡拒马河激情漂流+薰衣草乐园浪漫1日游	派对聚会	None
「City Arrow」一个专属于都市人的射箭俱乐部	运动健身	None
「限时售票」The Beatles！《纪念披头士乐队成立55周年――主题特展》来啦！	展览	None
【萌过】「2小时无限量畅玩」软陶DIY，大把萌物带回家	DIY手作	None
为2016年制作一支书写人生的红木手工笔	DIY手作	None
感受陶艺慢时光	DIY手作	None
弹着尤克里里，去那个只有我们的地方	文艺生活	None
「奥芝驿站长期活动」自助&互助烘焙派对・属于你的甜蜜下午茶	DIY手作	None
"像画一样精致的生,活~颐和路民国建筑里的【绘画艺术沙龙】"	派对聚会	None
请你来看「戏」：开心麻花《羞羞的铁拳》买一赠一，约上TA吧	戏剧	None
带上你的笑颜 记录最美年华｜跟拍 旅拍 街拍写真馆	派对聚会	None
【沪上超人气脱口秀优惠价】茄子周末秀 ― 让你欢笑一整晚	戏剧	None
惠东海螺角海岸线穿越，最美海水轻纱踏浪，乘快艇逐浪	户外活动	None
一生必看的世界名剧：「安德鲁与多莉尼」（剩余票型倒计时）	戏剧	None
这个夏天我要全身飘香 | 玫瑰果花草皂DIY	派对聚会	None
谁说我们不懂艺术，画给Ta看	派对聚会	None
后会无期中的纯洁之地 ― 东极岛	运动健身	None
李云迪2015肖邦传奇世界巡演	暂不开放	None
「动音会3.0」二次元世界的音乐会，玩儿现场的！	暂不开放	None
荒岛试炼，枕头大战、水上冲关，比游乐场还好玩，这个夏天倍爽！早鸟票正当时！快抢！	派对聚会	None
手工艺术体验|古典优雅的香道盛宴	派对聚会	None
放松自己，舞出小蛮腰！ 9元肚皮舞体验	运动健身	None
最美不过工笔画 | 丹青写出与君看（中山馆）	派对聚会	None
BIGBANG 2015 WORLD TOUR 成都站售票倒计时（售罄，请勿下单）	暂不开放	None
在自己的「秘密花园」躲过台风 ・ 作画、咖啡、下午茶	派对聚会	None
"3000年等待换一次相逢,如今有琴等你（莘庄馆）"	文艺生活	None
土火之艺，体验陶瓷里的慢时光	DIY手作	None
萌物当道 ・ 装进「微景观」里，咻咻咻	派对聚会	None
特种部队主题密室逃脱	派对聚会	None
当一天木工：挖勺 (黄桷坪专场)	DIY手作	None
七夕将至，用一下午的时光静静的为你爱的他”做一件牛皮钱夹	派对聚会	None
你离大师只差一杯下午茶时间！	派对聚会	None
BIGBANG亚洲巡回演唱会2015杭州站	暂不开放	None
绿动时光网球俱乐部－秋季练球	运动健身	None
零基础吉他体验课：音乐甜过爱情滋味，那些关于爱的小曲子	文艺生活	None
今年夏天给TA做一件最特别的礼物  ・ 扎染T恤自己做！	派对聚会	None
首触电美国最火的性格学，性格决定命名，了解自己的性格了解自己命名！	沙龙学堂	None
「特惠」传统木工课，鲁班锁手机支架	DIY手作	None
双人票|开心麻花爆笑舞台剧「旋转卡门」	戏剧	None
安静之处寄放喧嚣 ・ 当一次大师创造自己的油画作品	文艺生活	None
一对一心灵解密，一套神奇OH卡打开自我内在世界的大门，来抽一张不？	商业	None
高山草甸心开阔，忘忧湖边祛忧愁~游延庆玉渡山	派对聚会	None
玫瑰果花草洁面皂，DIY自制手工皂	派对聚会	None
软陶DIY联萌o(*RQ)ツ做多少带多少走~	派对聚会	None
布艺彩绘，自己画的最有面儿	派对聚会	None
不是所有的牛皮都可以做皮雕	派对聚会	None
清凉漂流 | 坐船去七里扬帆，湿身在葫芦峡漂流！	派对聚会	None
学习调一杯朗姆类鸡尾酒，给生活加点情趣	派对聚会	None
【文艺过】弹着琴 度过日光长长的盛夏祭	暂不开放	None
「前10名送日本团扇噢」体验日本姑娘的夏日祭生活 ・ 穿和服参加纳凉晚会~	派对聚会	None
我是一个小木匠，木工本领强，来啊来啊来，一起做木匠	派对聚会	None
双人套票| 经典爆笑舞台剧「乌龙山伯爵」	戏剧	None
【相遇过】摆出心里的沙盘：在这个醒着的梦里，相遇未知的自己	商业	None
天空之城 ・ 久石让宫崎骏作品视听音乐会	暂不开放	None
每周一起学画画！素描、油画、水彩、彩铅、国画！	派对聚会	None
「乌龙山伯爵」开心麻花爆笑舞台剧	戏剧	None
奔跑吧，找老外撕名牌草地野餐	运动健身	None
走进大自然，穿行于纵横交错的芦苇丛中，亲近白洋淀	派对聚会	None
做一个古典香囊，享受古韵飘香	派对聚会	None
另一半劈腿、出轨了，怎么办？	商业	None
大侠，来一斤波士顿大虾怎么样？两位客官同来？！再送一壶好酒！	DIY手作	None
一部真正让人毛骨悚然的舞台剧「维罗妮卡的房间」	戏剧	None
赏心悦事|徒步吴越古道，登浙西天池，赏漫山杜鹃	运动健身	None
真相只有一个，你能否找出？！侦探主题游戏「犯罪现场」	派对聚会	None
多肉微景观DIY，设计自己的植物萌宠（可以牵走哦~）	派对聚会	None
赖声川话剧「冬之旅」―蓝天野，李立群主演	戏剧	None
端午去周庄，包粽子/做风车/木刻年画	派对聚会	None
东篱・工笔共修	派对聚会	None
我从画中来 | 人人都是艺术家	DIY	None
稳准狠！让你快速上手的化妆教程	文艺生活	None
双人套票|爆笑舞台剧「羞羞的铁拳」	戏剧	None
征服千米玻璃栈道，山顶野餐大party――天云山1日游	户外活动	None
东篱・围棋共修	文艺生活	None
让你越跳越性感！ 9元肚皮舞体验	运动健身	None
论零基础木工的自我修养 | 食器专场	DIY手作	None
女神教你弹Ukulele（尤克里里）| 世界上最简单、最好玩的弹唱乐器	文艺生活	None
世界最大佛学院――色达朝圣之旅	运动健身	None
Starry starry night―梵高《星空》零基础油画体验课	派对聚会	None
自助画室	派对聚会	None
【假期行走】从化星溪线徒步，感受竹林深处的惬意	运动健身	None
驰骋楚门之外――来余杭南湖骑马吧！	派对聚会	None
一支铅笔一块橡皮创造的美丽，去体验黑白装饰画课吧	文艺生活	None
成都草莓音乐节 | 2015你只缺一个草莓（售票截止至今天中午12:00）	暂不开放	None
黑夜电影第二波 ・ 晚上林子里等你哟	派对聚会	None
【running man】奔跑吧！远方的路！ ―― 初夏的问候	运动健身	None
「画语艺术工作室」悄然回归，约你一起来画画~~~	派对聚会	None
自己动手，做条美裙出游去~	派对聚会	None
你不需要有基础，也可以成为莫奈，绘制一幅油画~~	文艺生活	None
粽香情浓，彩色水晶冰粽DIY――来做给你爱的人吧！	DIY手作	None
「企鹅的北极熊爸爸」：这个夏天，带你去地球尽头	戏剧	None
「搭建你的微观星球」，一起来做微景观吧~	派对聚会	None
「东篱 ・ 古琴共修」周日古琴共修	暂不开放	None
初夏不够热？撕场名牌怎么样（人多更优惠哦）	派对聚会	None
「超值有木有」单人零基础油画体验	派对聚会	None
浮光掠影―莫奈《睡莲》体验课	派对聚会	None
独角戏典范作品「一个陌生女人的来信」	戏剧	None
四步法让你的PPT变身高富帅！	派对聚会	None
「天空之城」久石让?宫崎骏动漫作品大型视听音乐会（预售中~）	暂不开放	None
初恋的味道，我来教你iDIY草莓芝士蛋糕~	DIY手作	None
天空之城―久石让宫崎骏经典动漫作品大型交响音乐会	暂不开放	None
温柔礼物：木戒指＆木首饰＆木领结	DIY手作	None
「夏日远r」成都站―岛歌王子中孝介	暂不开放	None
质感，淌过每一针一线	派对聚会	None
千岛湖 | 他们都有快乐的童年	派对聚会	None
零基础非洲鼓公开课	暂不开放	None
岩壁上的芭蕾 | 室外攀援	运动健身	None
点燃心火 破茧成蝶 ・ 「洛丽塔LOLIT」随园南京封箱场	戏剧	None
「优惠限额・插花体验」米洛花艺沙龙，当个周末的插花师	体验课	None
「2015你只缺一个草莓」草莓音乐节预售开始！（早鸟票须抢！）	暂不开放	None
蓝染工作坊，拯救夏日闲置白t－shirt！	派对聚会	None
聊聊节日那些事儿：为什么不能和犹太人说圣诞快乐”呢？	派对聚会	None
「幸福不过做匠人」，皮具银饰自己做~（豆浆面汤手工课全目录）	派对聚会	None
【来个小插曲】你的宠物也要聚会，带上你的宠物出发吧！ ・ 宠物餐厅开放日	派对聚会	None
我只想做个安静作画的人 ・ 兔子美术成人班	派对聚会	None
大型盗墓舞台话剧「鬼吹灯」之精绝古城惊悚版(上部)	戏剧	None
龙猫乐团―从「天空之城」到「起风了」音乐会	暂不开放	None
Your perfect wedding ・ 你的礼花怎会比别人差！	派对聚会	None
"[PainterGo]绿地赵家墩ZOO COFFEE,零基础约画《守望灯塔》，送33元以内饮品！"	文艺生活	None
滑翔 | 9.16 为你插上飞翔的翅膀，带你装逼带你飞！	户外活动	None
做一个有「逼格」的卡包，超值手工牛皮基础技巧体验课！	派对聚会	None
「古琴沙龙」琴曲及琴歌赏析、现场学弹一首简单的古琴曲	暂不开放	None
一起跳舞吧，从零基础开始	运动健身	None
给你：一个24小时热水的家	派对聚会	None
City Imortal 城市不朽 | TEDxTangdaowan2015年度大会	派对聚会	None
2/27夜巴黎  2/28普罗旺斯花海	派对聚会	None
零基础油画体验：谁说我们不懂艺术，画给TA看	派对聚会	None
剑道体验 | 剑道人的匠心精神：苍穹为剑气，天地化锋芒！	运动健身	None
「手慢无」西安草莓音乐节票开抢！（学生&成人）	暂不开放	None
还没听过相声？周末大华笑一笑	暂不开放	None
迷笛电音音乐节露营party	暂不开放	None
「临时情侣」撕名牌推理战	运动健身	None
乌拉洛斯uranus占星之旅初级课程	派对聚会	None
这个夏天，亲手做条美裙出游去~	派对聚会	None
「深圳专享 ・ 一元抢购 」陪母亲吃顿温馨饭	DIY手作	None
「杭州专享 ・ 一元抢购 」陪母亲吃顿温馨饭	DIY手作	None
带上好心情，甩掉人山人海，和自由一起去黄山吧！	派对聚会	None
「上海专享 ・ 一元抢购 」陪母亲吃顿温馨饭	DIY手作	None
「北京专享 ・ 一元抢购 」陪母亲吃顿温馨饭	DIY手作	None
母亲节到了，带妈妈听个相声吧	戏剧	None
岛屿来信：听说夏天和皮划艇更配哦	运动健身	None
一起走吧|中国十大徒步线路――徽杭古道	户外活动	None
「独家首发」五月新开放海岛，新晋马尔代夫中国版！	派对聚会	None
一生总要看一次「皮影戏」	戏剧	None
「半价抢票」五一狂欢大派对 ― 特逗潮流GO	派对聚会	None
2015迷笛音乐节	暂不开放	None
体验古法蓝染 | 或斑驳、或美妙、或轻柔……	DIY手作	None
BA支付规则测试	电影	None
【周六】上帝遗落的调色板，醉美秋景<喇叭沟门精品小团	户外活动	北京
<暑期体验课拼布小猫钥匙包	派对聚会	北京
妆出美！穿出范儿！让明星的私人造型师―快速教会你化妆＆服装搭配	沙龙学堂	北京
寻找《北京的秋天》色彩写生	文艺生活	北京
【福利派送】京城首家最潮美食集合店空降三里屯，育膳房送你现金去体验！	派对聚会	北京
［11.19周六］青年路羽毛球	运动健身	北京
周六天津休闲游一日游：赏欧式建筑、品小吃、出海	户外活动	北京
11.19周六，奔跑吧兄弟：古北水镇-司马台长城休闲游	户外活动	北京
心理学|  选择综合症有救啦~ 潜意识帮你做决定！	沙龙学堂	北京
心理学| 明天就要嫁给你啦，一粒沙看清我们的未来	沙龙学堂	北京
晒秋 ・ 婺源 摄影师的天堂、醉美秋季！	户外活动	北京
DIY 羊毛毡的温暖世界	DIY手作	北京
拉丁风情salsa舞	运动健身	北京
【感恩节特惠】DIY一个独一无二的银戒指 仅需120元！	DIY手作	北京
DIY熔岩蛋糕，再兑上牛奶喝世界上最好喝的热可可	DIY手作	北京
人间终极洗肺松弛套餐矿物精油经络疏通全身按摩+死海清肺盐疗 （单人单次）	派对聚会	北京
单人GX精品小团课--私人健身	运动健身	北京
给我一首歌的时间，学会周董经典之作《安静》	文艺生活	北京
"香道体验 | 自己动手制作沉香线香,附送香篆体验课"	DIY手作	北京
面聚・狼人杀 | 4阶大神还是小白？！我在面聚等你~	派对聚会	北京
DIY三角饭团，再带你去吃世界上最好吃的拉面”	派对聚会	北京
特价车费仅1元！畅游石林峡，挑战世界第一UFO玻璃平台！	户外活动	北京
咖啡基础知识｜从种子到杯子	文艺生活	北京
性格沙龙：突破性格局限，拥抱更好的自己	沙龙学堂	北京
【万圣节专辑，尤克里里DIY】玩转暗黑系炫酷小吉他	DIY手作	北京
做衣服这种事情用的着洪荒之力？	DIY手作	北京
【周末畅游】醉美秋景坡峰岭，赏漫山遍野红叶！	户外活动	北京
森系毛呢大衣，暖暖的文艺范儿	DIY手作	北京
周末北方张家界天云山玻璃大桥横空出世，有胆你就来！	户外活动	北京
A4腰--你的女神身材新标准	运动健身	北京
一个月声乐课程=99元（艺山林音乐工作室）	沙龙学堂	北京
周六，奔跑吧兄弟拍摄地：古北水镇-司马台长城一日休闲游	户外活动	北京
畅游古北水镇，登司马台长城，赏秋色、看最美古镇夜景！	户外活动	北京
素人改造 | 你的美丽，我来买单！	沙龙学堂	北京
【每周1日】只需要79元带你去看古北水镇，山水城结合的自然古村落！	户外活动	北京
擦蜡卡包DIY | 做一款帅气的卡包【送琥珀DIY课程】	DIY手作	北京
刺绣这么火 你不来一件？	DIY手作	北京
周末带你去被誉为京西小九寨沟的双龙峡”，乘坐森林小火车	户外活动	北京
万圣节化妆派对丨让我们一起变装一起'鬼混'	派对聚会	北京
周末一起跳舞吧！12个舞种任意选！一节课也能学会一段舞！	运动健身	北京
漫步北京最大银杏林，赏七孔桥红叶林秋色，一日休闲活动！	户外活动	北京
【周末】漫步万亩银杏林，徒步七孔桥赏秋色，品正德春饼宴	户外活动	北京
10月30日日语零基础试听｜2020年东京奥运会约不约？	沙龙学堂	北京
三里屯2200平「阅后即焚」屠宰场只在今夜开放	派对聚会	北京
双龙峡 邂逅京西小九寨，搭上穿越红叶的森林小火车！	户外活动	北京
皖南，以秋之名，用颜色来诉说一个童话！（已成行）	户外活动	北京
万圣节单身派对， 你的爱情将不再神出鬼没	派对聚会	北京
悍匪”万圣夜 | 史上最不讲理的悍匪主题万圣之夜，  我们等你来猖狂！	派对聚会	北京
玩转相机 【好好玩儿摄影】零基础开课啦 | 一起外拍，你准备好了吗？	文艺生活	北京
好好玩儿摄影零基础课程 | 玩转相机只需现在开始，轻松拍大片儿	文艺生活	北京
2017年元旦去东北看雪去：看雾凇打雪仗，激情穿越雪谷雪	户外活动	北京
【每周1日】只需70元一起去逛双龙峡 ---- 京西小九	户外活动	北京
DIY小配饰，热胶片插画手作Workshop	DIY手作	北京
软陶胸针＆冰箱贴＆钥匙链DIY | 用双手点亮生活!	DIY手作	北京
早知有盘山，何必下江南”~11.05日周六天津蓟县盘山	户外活动	北京
神秘塔罗牌，解读你的幸福 | 专为单身人士解读爱情	派对聚会	北京
瑜伽――吉赛尔娘娘修炼气质的秘密武器	运动健身	北京
【心理沙龙】体验OH卡牌☆遇见真实的自己	沙龙学堂	北京
【两人同行 一人免单】葡萄籽精油 spa 90分钟套餐	文艺生活	北京
"10月23日 向世界开\""泡\"""	运动健身	北京
没关系，音乐就是后悔药――赫梯吉他课	沙龙学堂	北京
尤克里里很酷，而你正好有空	文艺生活	北京
【狼人杀】丨【桌游交友】の 有你有我还有未曾谋面的她	派对聚会	北京
【两人同行 一人免单】90分钟观影足疗推拿套餐	文艺生活	北京
零食蛋糕测评！DIY体验+全球13款网红蛋糕	派对聚会	北京
我画了一幅画挂家里，炒鸡美！	文艺生活	北京
节奏??聚集地 骨头节奏 架子鼓体验课	文艺生活	北京
【双龙峡】人间氧吧，京西九寨，赏秋正当时	户外活动	北京
给你一个机会，去认识更多行业、更多朋友！打开心扉，从容地面对情感问题。	派对聚会	北京
[ 手工皮具]炎炎夏日，让手作给你降温吧～	DIY手作	北京
男士私人定制整体形象设计课程（精华版）！	沙龙学堂	北京
秋意真浓-北京延庆百里山水画廊-乌龙峡谷-一日秋游好去处	户外活动	北京
裁古韵旗袍 承匠人精神	DIY手作	北京
帅气纹身师为你打造独一无二的纹身，留住美好的标记	文艺生活	北京
【 两人同行 一人免单】天然有机葡萄籽精油SPA，让你全身得到由内而外的放松	沙龙学堂	北京
金秋赏红叶 喇叭沟门红叶行摄，白桦林间仰望秋	户外活动	北京
克服上台紧张，让自己思考清晰表达有力【亲，已发布同样的活了哦】	沙龙学堂	北京
解读皮肤密码，订制护肤方案 现场体验 承诺100%有效	沙龙学堂	北京
咖啡基础知识｜到咖啡店点单不露怯	文艺生活	北京
怀抱初心，寻古探味――传统中点制作体验课	DIY手作	北京
美衣陪你靓扮每天  来约吗？	DIY手作	北京
畅游玉渡山秋景，赏高山草甸、香闸瀑布、百蝶泉，漫步忘忧湖畔！	户外活动	北京
法式苹果派，DIY一份不一样的浪漫甜蜜（须电话预约）	DIY手作	北京
十一特辑 | 油画、水彩、彩铅、素描、速写全玩遍	文艺生活	北京
DIY翻糖纸杯蛋糕（须预约）	DIY手作	北京
■ 水彩花卉课堂	DIY手作	北京
Livehouse死忠局，等你加入！【亲，咱们平台不支持演出类的活动哦】	派对聚会	北京
三节课学会尤克里里 上门一对一教学	文艺生活	北京
【十一国庆特惠闪购--尤克里里DIY】亲手做一把小吉他	DIY手作	北京
迷境Ar caching―增强现实丛林寻宝之旅	户外活动	北京
公开课 | 克服紧张尴尬癌，从容优雅讲故	沙龙学堂	北京
【国庆节特惠●尤克里里精品集训课】3天拿下弹唱利器！	文艺生活	北京
解救单身狗”11.11单身派对	派对聚会	北京
【周末】徒步京西古道赏秋，感受千年古风遗韵	户外活动	北京
爱在10.1罗马湖秋游?烧烤 唱歌 欢乐趴！	户外活动	北京
十一国庆画幅画给自己收藏，单幅油画体验课	DIY手作	北京
气质女性必修――芭蕾形体公开课	运动健身	北京
一日”云中漫步”玻璃桥已横空出世，快来体验这令人惊叫的感觉吧！	户外活动	北京
个人标准形象设计体验 | 挖掘隐藏在你身上的天然美	沙龙学堂	北京
做条百搭好看阔腿裤时尚指数飚起来！	DIY手作	北京
赏喇叭沟门秋色，北京秋天的童话世界，漫步白桦林、枫叶林，登南猴顶！	户外活动	北京
浪漫双人DIY陶艺体验 | 陶器，带有泥土的味道，透露着原始魅力。	DIY手作	北京
十一【恒山 3日】山西悬空寺、云冈石窟、平遥古城、乔家大院	户外活动	北京
咖啡研磨的正确姿势｜教你如何做好喝的咖啡	文艺生活	北京
刺绣丝巾 | 轻柔绽放知性美 10月22日	DIY手作	北京
北京周末户外单身交友活动	户外活动	北京
9.25邂逅latte文化 | Latte Art意式咖啡拉花艺术初级体验课	文艺生活	北京
国画零基础  体验水墨画由浅入深的墨韵	文艺生活	北京
奶酪史诗级测评！全球最佳13款顶级奶酪品鉴！6种酷炫吃法！好玩桌游！	派对聚会	北京
【古琴零基础960元特价课程】从零开始，6周改变自己	文艺生活	北京
【国庆9.30-10.3一期】轻装库不齐沙漠，感受大漠孤烟直	户外活动	北京
免票相约五台山 | 朝圣、祈福、还愿，醉美大五朝台路！	户外活动	北京
国庆假期：畅游秋色阿尔山-呼伦贝尔草原-根河湿地-莫尔道嘎	户外活动	北京
秋天，来一件简约百搭的马甲外套	DIY手作	北京
中秋假日一起花好月圆 自由西式插花课程	DIY手作	北京
厂房里的大艺术：让我带你去寻找798艺术区里的那些老故事	文艺生活	北京
轻私塾调酒课｜教给你的全都是干货，一起来挑战调酒师！	DIY手作	北京
【零基础油画体验】画画如此快乐，你还不来！？【ART画匠绘画画室】	DIY手作	北京
中秋博饼趴，北漂一族的最好选择！	派对聚会	北京
【书法周末班】书法孟博士带你写好毛笔字，其实写字没有那么难。	文艺生活	北京
9.15中秋特辑|月饼界的时尚新宠，中秋冰皮月饼制作!	DIY手作	北京
现金流活动----演绎人生40年	派对聚会	北京
【中秋假期】秋色浸染草原天路”两日游	户外活动	北京
修炼中式雅致 开启香韵生活--香道篆香体验	DIY手作	北京
干我们这行的，就只能去别人家翻箱倒柜了	文艺生活	北京
畅游北方张家界天云山，体验云中漫步”悬空玻璃吊桥！	户外活动	北京
懒人也要喝好咖啡----浸泡式萃取 | get一大波咖啡制作技能	沙龙学堂	北京
中秋特辑 | 零基础画星空画月亮	文艺生活	北京
中秋 ・ 草原 中（金）秋行摄-乌兰布统草原！	户外活动	北京
DIY冰皮月饼 送给想团聚的人~	DIY手作	北京
欧巴教你弹钢琴，成人零基础学琴零压力	文艺生活	北京
想改变自己的形象，却不知道从何下手？	沙龙学堂	北京
【本周六9.24】赏高山草甸、香闸瀑布、百蝶泉、漫步忘忧湖畔，玉渡山一日活动	户外活动	北京
快到中秋月圆时，为心爱的TA亲手做一盒月饼	DIY手作	北京
赴刀石之约 ---篆刻你的印”	DIY手作	北京
露营 闻库布奇大漠孤烟，穿越最美沙漠之一！	户外活动	北京
零基础成人速成钢琴体验 | 学会钢琴，完成儿时梦想	文艺生活	北京
中秋假期，轻装徒步库布齐沙漠，赏天下黄河老牛湾、乾坤湾！	户外活动	北京
The Deep End 深水区｜简单心理故事客栈第二期	派对聚会	北京
古琴课 . 余音袅袅，古韵幽香	文艺生活	北京
【高山流水邂逅知音】古琴零基础体验	文艺生活	北京
原气花铺插花体验课，花材拯救大作战--野兽派花艺师亲授	DIY手作	北京
喇叭沟门原始森林一日徒步休闲活动	户外活动	北京
【中秋假期】狼图腾拍摄地乌拉盖大草原”3日行摄游	户外活动	北京
来一场旧衣大改造 | 每个女孩心目中都有一个服装设计的梦想	DIY手作	北京
轻私塾会员专项｜免费活动＋课程折扣＋HOPS会员	文艺生活	北京
中秋 徒步行摄中国最美的峡谷之―南太行穿越：双底村―马武寨―抱犊村-八里沟	户外活动	北京
三好书院 | 书法短期精品十课时小班随到随学！	文艺生活	北京
畅游四季花海，薰衣草＆向日葵园＆珍珠泉＆永宁古城一日休闲游！	户外活动	北京
尤克里里轻松弹唱【成功预约 超值体验】感受学习音乐的乐趣与动力。	文艺生活	北京
9月11日礼仪课|绅士和淑女之约，西餐礼仪和餐酒配搭速成！	沙龙学堂	北京
【周六】 徒步徒步灵山古道，登北京之巅：东灵山	户外活动	北京
热攀嘉年华火热开启！「自助晚餐+攀岩」让您嗨个够！	户外活动	北京
如何快速拥有一个多金的男朋友	沙龙学堂	北京
勇敢传说之天云山玻璃大桥体验之旅	户外活动	北京
中秋假期：山西晋中文化之旅~平遥+乔家大院+云冈石窟+悬空寺	户外活动	北京
麻辣个班” 商务口语＋沙拉  （零基础体验课）	沙龙学堂	北京
中秋冰皮月饼 烘焙DIY课程  多种口味可选	DIY手作	北京
躁动节奏不停歇 架子鼓单次体验课	文艺生活	北京
想把我弹给你听----尤克里里弹唱入门	文艺生活	北京
处女座狂欢趴体，12星座都不容错过的处女”情怀狂欢趴！	派对聚会	北京
周末去干嘛？对方不想说话并向你扔了一幅画	文艺生活	北京
书法----造纸术 | 从原纸浆开始，用行动告诉你关于造纸的一切。	文艺生活	北京
"9.15中秋特辑 | 今年只会更流行，中秋新宠\""--桃山皮月饼体验课！"	DIY手作	北京
中信银行＆悦跑圈粉红女子跑 2016北京站 | 跑出阳光，跑出美丽，跑出好身材	运动健身	北京
畅游北方张家界天云山，云中漫步”玻璃大桥横空出世！	户外活动	北京
你的美丽由自己决定	沙龙学堂	北京
周末畅游石林峡，挑战世界第一UFO悬空玻璃观景平台！	户外活动	北京
《爱在夏日》系列Party―北京人气最高单身派对第17期	派对聚会	北京
8月28日，法意最佳起泡酒大起底，泡沫之夏”专场品鉴会	派对聚会	北京
个人高级形象设计体验 | 打造你的专属美丽	沙龙学堂	北京
8.28红酒鉴赏 | 与美酒最好的相遇，葡萄酒达人初级品酒课程	沙龙学堂	北京
画一幅有趣的油画，零基础油画体验	文艺生活	北京
零基础扎染课程－扎缝一幅小画	DIY手作	北京
相遇在北方的小乌镇----古北水镇	户外活动	北京
中秋节： 库布齐沙漠西线―夜鸣沙 神海子 爱情湖 七星湖露营	户外活动	北京
亦陈亦新，用经典超越时光	DIY手作	北京
每周末 畅游四季花海，薰衣草＆向日葵园＆珍珠泉＆永宁古城一日游	户外活动	北京
月满入梦，饼承心意――月饼DIY超值体验课	DIY手作	北京
书法--沐手抄心经 | 归置本处，抄经功德圆满	沙龙学堂	北京
海岛 荒岛求生 ・ 在美丽的无人岛，扎营烧烤，抓海鲜（仅限50人）	户外活动	北京
【两日五台山】在这甜味儿飘香的季节，让我们情定大五台~~~	户外活动	北京
中秋假期：玩转山西五大经典景区：云冈石窟、悬空寺、北岳恒山、乔家大院、平遥古城，三日休闲活动。	户外活动	北京
高端健身私教课体验――量身定制成就你的美，只属于你的私人健身方案	运动健身	北京
对喧嚣最好的逃离，是在画室手执画笔	文艺生活	北京
还在画秘密花园？不如来画一幅真正的彩铅！（赠画框）	文艺生活	北京
天气”一日十渡如此炎热，据我所知，95%的人都会选择去这里清凉一夏哟！	户外活动	北京
【周六活动】舌尖味蕾上的缠绵――探索30种鱼干的美味+小酒会	派对聚会	北京
戏剧表演体验课（对零基础表演爱好者）	文艺生活	北京
跳舞吧！12个舞种任性选！	运动健身	北京
炎炎夏日，密云捧河湾摸虾拾贝 白云峡谷溯溪休闲打水仗（1日行程）	户外活动	北京
8.20日周六：抓住夏天的尾巴，十渡东湖港再来一次湿身活动	户外活动	北京
美女变形”计 | 如何寻找属于自己的美？	沙龙学堂	北京
带你区别各类家用咖啡机 | 享受即磨即冲咖啡豆的色香味	文艺生活	北京
拉丁舞单次体验课（零基础）	文艺生活	北京
9月25日法语零基础试听课｜其实说法语可以很简单	文艺生活	北京
别怕，零基础也可以画好水彩画	文艺生活	北京
艺山林音乐工作室场地出租	派对聚会	北京
四合院里画个海纳纹身~纯植物无痛还美美哒~	DIY手作	北京
团扇DIY 轻罗小扇扑流萤	沙龙学堂	北京
零基础绘画体验 | 油画、丙烯、素描、速写、水彩、彩铅	文艺生活	北京
沐浴春日暖阳，优惠继续来袭！	DIY手作	北京
【旅行】简易版护照夹 | 海枯石烂也要陪你，一如初见	DIY手作	北京
课程｜零基础风雅团扇绘制	DIY手作	北京
登高望远----挑战北京最高峰【东灵山】	户外活动	北京
8.13 | 咖啡品鉴课程|一杯咖啡教会你慢慢的精致”	文艺生活	北京
别怕，零基础也可以画好油画	文艺生活	北京
国庆假期：轻装徒步库布齐沙漠+天下奇观黄河老牛湾	户外活动	北京
8月9日七夕情人节 ・ 蓝溪接吻大赛	派对聚会	北京
七夕如期而至，不早不晚丨遇见你，不管时光，不问流年	派对聚会	北京
M主题diy微景观――塑造你心中的世界！	DIY手作	北京
飞舞吧！钢管舞！对抗地心引力！	运动健身	北京
为你和你的他，亲手做一套属于你们的私人专属定制套装	DIY手作	北京
十分钟爱上尤克里里 | get一项21世纪小清新文艺范儿的新技能	文艺生活	北京
只想画一个女孩 | Clare Elsaesser 油画临摹活动	文艺生活	北京
有一种能力你必须具备 | 如何克服紧张？	沙龙学堂	北京
8月7日，新旧世界葡萄酒帝都大对决--赤霞珠主题品鉴会	沙龙学堂	北京
两日十渡”十渡嗨玩节	户外活动	北京
8月7日趣野 ・ 极限挑战第十期【高空溜索and岩壁崖降】 活动召集！	户外活动	北京
取悦自己，从拥有一个口金包开始~	DIY手作	北京
神堂峪栈道+篱苑书屋，最有创意的图书馆，有山有水有美女	户外活动	北京
七夕脱单全攻略，小派带你去抢亲！	派对聚会	北京
8.6~7日（周末）：别样海滩翡翠岛，露营、畅游、漫步、烧烤	户外活动	北京
清凉一夏 | 翡翠岛，沙漠与大海的吻痕，游泳、冲浪、露营、BBQ！	户外活动	北京
TOUCH假日牧场邀请您感受马术的魅力	运动健身	北京
8.20 周六：漫步神堂峪山水栈道+阅读天堂篱苑书屋	户外活动	北京
夏日午后  与油画为伴	文艺生活	北京
戏剧表演体验课（零基础表演爱好者）	文艺生活	北京
清凉一夏 | 十渡东湖港-瀑布-玻璃栈道，划江南竹筏，拒马河漂流！	户外活动	北京
汪星铲屎官 ， 夏日狂欢party	派对聚会	北京
你的力量”分享会：和职业公益人、旅行者、创业者一起聊聊我们的力量	派对聚会	北京
周末约吗？ 最新潮的Bubble Soccer 泡泡足球就在朝阳公园！	运动健身	北京
如何讲好故事	沙龙学堂	北京
8月海坨山扎营，日出日落观云海	户外活动	北京
北京英语角高水平人群讨论 - you talk club	沙龙学堂	北京
一起来体验品尝30种凤梨酥+DIY手工制作凤梨酥吧	DIY手作	北京
现金流游戏--桌游 | 开启自己的投资理财天赋，迈向财务自由	派对聚会	北京
去白河搭帐篷了！	户外活动	北京
扇面国画体验课 | 一把清雅扇 伊人半遮面	DIY手作	北京
漫步神堂峪山水栈道，游览全球最美18家图书馆之一的篱苑书屋	户外活动	北京
【邀请函】时尚发布酒会全球第二季 | 美丽从这里开始	派对聚会	北京
【舞魅一夏】肚皮舞公开课：最美肚皮舞女神教你如何炼成充满女人魅力的”小腰精	运动健身	北京
钢琴Vs唱歌 约你~！	文艺生活	北京
每个女人都有变美的权利｜轻私塾精品化妆课程	文艺生活	北京
为你，弹奏一首吉他曲	文艺生活	北京
带你亲手做这个夏天人手一件的荷叶袖上衣	DIY手作	北京
用一个下午的时间，为自己设计一款绝不与别人撞衫的衣服！	DIY手作	北京
CBD静下来的一笔一画，水彩画体验，赠实木画框一个	文艺生活	北京
［手工皮具］极简风钱夹 夏日手作体验～	DIY手作	北京
7.30-31日张北草原音乐节【你负责带着一颗摇滚的心→爱游带你去一片摇滚天地-露营+烧烤】周末蓄势待发	派对聚会	北京
余音袅袅  零基础古琴课招生	文艺生活	北京
话题福利丨你的热气球飞行梦，娜娜户外帮你实现！	派对聚会	北京
成人戏剧表演体验课	文艺生活	北京
京城最有料饭局――听我们讲讲牛排和餐具的故事	派对聚会	北京
与美丽有个约会	沙龙学堂	北京
DIY手冲咖啡	文艺生活	北京
大师教你学钢琴，快速晋级钢琴大咖	文艺生活	北京
提升人际交往能力：教你如何进行有效沟通	沙龙学堂	北京
白云峡谷捧河湾，溯溪捉虾拾贝，戏水狂欢	户外活动	北京
畅聊精酿啤酒	派对聚会	北京
艺术馆里画油画	沙龙学堂	北京
周周发【坝上草原专线】看日出、骑马、篝火`烤全羊	户外活动	北京
一日北森撕起”奔跑吧	户外活动	北京
曼陀罗心理疗法重磅来袭，体验催眠，释放真我！	沙龙学堂	北京
首饰DIY-制作押花饰品，凝固绽放之美	DIY手作	北京
【心理】你有烦恼吗？请进	沙龙学堂	北京
7月23日趣野 ・ 极限挑战第八期【高空溜索and岩壁崖降】 活动召集！	户外活动	北京
百变手冲咖啡课堂	沙龙学堂	北京
成人炫舞 | 心随舞动，A4腰马上练出来	文艺生活	北京
茶艺体验 | 从一杯香茗中净化自己的心境	茶会雅集	北京
TOUCH马背体验之旅 | 与小马一起奔跑，释放孩子的纯真天性	户外活动	北京
书法的纯粹之美，你还记得么？	茶会雅集	北京
国画体验课 | 写意山水，墨里春秋	茶会雅集	北京
?以印为信｜方寸之间，气象万千――零基础篆刻课程	DIY手作	北京
【东篱-硬笔书法】一手好字相伴一生	沙龙学堂	北京
开启味蕾上的葡萄酒之旅	文艺生活	北京
双管齐下洗肺护肤套餐死海泥抗衰精华面膜＋清肺盐疗单人单次	派对聚会	北京
高效燃脂（小团体私教）| 正确瘦身，才不会反弹	运动健身	北京
暑期特价北戴河，漫步渤海湾黄金海岸，徒步国内最长沿海木栈道	户外活动	北京
精油制作丨国际芳香治疗师Tana带你走上芳香之路	文艺生活	北京
你出门真的会穿衣服吗？	DIY手作	北京
死海清肺抗雾霾  快乐亲子盐疗套餐（3－4人）	派对聚会	北京
畅游石林峡，挑战世界第一悬空玻璃观景平台！	户外活动	北京
暑期特价：258元超值畅游北戴河	户外活动	北京
锡林郭勒草原狂欢节：彩跑・露营・音乐・烤全牛・篝火・许愿灯，千人帐篷彩跑文化节！	户外活动	北京
古筝体验 |  二十一弦的跳跃，弹出你心中的高山流水	茶会雅集	北京
吸着盐疗看电影超健康单人套餐	派对聚会	北京
当电影遇上英语 | Who is your superhero？	派对聚会	北京
【中秋】徒步京西古道，感受千年古风遗韵	户外活动	北京
G弦上的咏叹调与ACG配乐#音乐欣赏和家庭演奏茶会#	文艺生活	北京
Dimo私塾 ● 初夏音乐会  |  @蜗牛的家咖啡馆	暂不开放	北京
简单既是最深刻的美！棉麻旗袍DIY	DIY手作	北京
手工皮具 | 流行复古眼镜盒，在旅行的路上一直有它	DIY手作	北京
DIY一件高腰小A裙，胸以下全是腿	DIY手作	北京
背带裙太幼稚？别找借口，那是因为你不会穿！	DIY手作	北京
团扇国画复古手工扇子花鸟绘画礼物	文艺生活	北京
成人戏剧表演体验课 | 内心的激情在瞬间迸发	沙龙学堂	北京
少儿戏剧与音乐剧体验课 | 发掘孩子的天赋，自信面对人生	沙龙学堂	北京
雅致香生活--夏季暑期香道特惠【五人精品小班】	沙龙学堂	北京
一款合身美衣，今夏帮你找到最美的自己	DIY手作	北京
合气道 | 实用又有趣的武术，专为都市亚健康人群打造的防身技！	运动健身	北京
手绘T恤，穿出与众不同的自己	DIY手作	北京
【线上微活动】性， 吴亦凡， 夜生活，让世界知道你的偏见	派对聚会	北京
【海坨扎营】  户外圣地最美山峰，一起山上看星星	户外活动	北京
独立电影《医院里的中国/People's Hospital》展映及导演交流会	暂不开放	北京
【7月2-3日】畅享浅水湾，欢乐水世界，海鲜大排档嗨起来！	户外活动	北京
9.11穿行老北京胡同，来一场说走就走的人文之旅	户外活动	北京
尤克里里、吉他弹唱体验课	暂不开放	北京
坝上草原骑马、篝火狂欢，免费酒水和烤全羊，马”上约起来吧！	户外活动	北京
【线上微活动】一节课告别书法小白”，走进大师的水墨世界	沙龙学堂	北京
【线上微活动】以美呼唤自由，理想与情怀的邂逅	文艺生活	北京
一年一次海坨山扎营，日出日落观云海	户外活动	北京
【线上微活动】漫步澳门，让草地音乐伴你同行	暂不开放	北京
调酒世界――一起创造鸡尾酒的一万种可能！	文艺生活	北京
【特殊技能】告诉你创业公司合伙人及员工的正确打开方式	沙龙学堂	北京
曲径通幽百花山，赏百花齐放、高山草甸，一日登山活动！	户外活动	北京
7月2日【天津北塘出海打渔】北塘古镇腐败一日游@吃货，快来！	户外活动	北京
手冲咖啡：精致的仪式感	文艺生活	北京
青年导演短片展及映后讨论 Short Films Show Case and Directors Q＆A	文艺生活	北京
畅游十渡东湖港，划江南竹筏，拒马河激情漂流！	户外活动	北京
爱他，就为他做件衬衫吧！	DIY手作	北京
【十元专享】单次健身体验	运动健身	北京
吉他弹唱You are my sunshine	文艺生活	北京
?福匠夏季换书会 让知识流动起来	文艺生活	北京
"顶级私人教练打造你的\""形\""―美出你的调调让男人垂涎吧！极速瘦身塑形"	运动健身	北京
【夜景模式】游北方小乌镇-【密云-古北口水镇-司马台长城】一日休闲活动	户外活动	北京
柔化你的芳心-韩式裱花课程（一对一）	DIY手作	北京
拉丁舞＋沙拉＝夏日完美组合	沙龙学堂	北京
【线上微活动】合适自己的才是最好的，找到属于自己的穿衣风格	派对聚会	北京
【塑形轻食活动】像 饭祷爱”一样，收获爱之前，请先减肥	运动健身	北京
在绘画中倾听花开的声音	文艺生活	北京
三好书院钢笔字 | 你字会写好，妈妈都知道	文艺生活	北京
彩铅 色彩 零基础画画 绘画艺术礼物	文艺生活	北京
世界精酿啤酒专业讲解	派对聚会	北京
为父亲穿针引线	DIY手作	北京
零基础国画（团扇）  画一把属于自己的扇子	文艺生活	北京
蜕变，让他从心”爱你一次	沙龙学堂	北京
仅需158元，世界名曲轻松上手，成就你的钢琴梦想	文艺生活	北京
京郊小九寨【玉渡山】  ――高山草坪、香闸瀑布、百蝶泉、一日休闲摄影活动	户外活动	北京
相约周五俱乐部	派对聚会	北京
香道 | 在胡同院子里制香，半生身老心闲	沙龙学堂	北京
北京高校爱情毕业典礼＆交友音乐节	暂不开放	北京
石林峡+玻璃观景台~特价99元：车费、门票、观景台、保险全含！	户外活动	北京
周日 | 名校名企单身专场 告别单身	派对聚会	北京
京城最文艺最专业的零基础绘画体验	文艺生活	北京
6.10端午节品酒会|诗意法国・主题音乐品鉴酒会	派对聚会	北京
丁源＆刘润洁 女声民谣专场	暂不开放	北京
挑战十渡1500M高空岩壁玻璃栈道一日游另送漂流，竹筏	户外活动	北京
石林峡勇者奇遇记 ――悬空美景，挑战世界第一大UFO玻璃观景台	户外活动	北京
【手工皮具】长款钱包/手拿包	DIY手作	北京
陶冶性灵 印章篆刻	DIY手作	北京
【懒人定制】大批粽子军队来袭，快快接招！！！	DIY手作	北京
踩上玻璃栈道，挑战自己小心脏	户外活动	北京
永远的经典单品-白衬衫让撩汉技能满点	DIY手作	北京
旋风滑轮・体验之旅	运动健身	北京
创意团队活动	文艺生活	北京
人美就要多读书 ――探寻最美阅读天堂篱苑书屋，世外桃源神堂峪	户外活动	北京
石林峡UFO重磅来袭	户外活动	北京
闻WENNE艺术美学|软陶DIY	DIY手作	北京
观影会之《变脸》，给你不一样的感动。	派对聚会	北京
【端午假期出行】蓬莱长岛海外仙山，海鸥海鲜样样俱全	户外活动	北京
端午假期，走进山东青岛，免票爬崂山，畅游灵山岛，三日休闲之旅！	户外活动	北京
火车团-长白山、魔界、天池	户外活动	北京
DIY创意沙画体验课	DIY手作	北京
畅游玉渡山，赏高山草甸、香闸瀑布、白蝶泉，漫步忘忧湖畔！	户外活动	北京
【端午假期出行】丰宁坝上草原・蓝天白云，策马扬鞭	户外活动	北京
端午假期，相约美丽海岛「长岛・蓬莱」	户外活动	北京
躺在云端看风景，走近蒲洼 ――寻京郊小西藏”，最美梯田	户外活动	北京
一节课就能学会吉他、尤克里里｜【知e造。】音飞除	沙龙学堂	北京
常见咖啡制作方法大全	沙龙学堂	北京
【优惠中】抉择虚拟现实（vr）体验馆	派对聚会	北京
不惧地心引力，岩壁上的芭蕾（单人体验）	运动健身	北京
【懒人好物】「草木染手织布」手工钱包+笔记本组合装	DIY手作	北京
简约即时尚、新手DIY动感A裙	DIY手作	北京
『助纣为乐』纣王新专辑《友谊胡同》全国巡演	暂不开放	北京
懒人 ・ 好物推荐 |  云手艺竹编材料包	DIY手作	北京
坝上草原任我行	户外活动	北京
穿行老北京胡同，来一场说走就走的人文之旅	户外活动	北京
小原流花道 | 感受东方花艺的古典美	沙龙学堂	北京
《宫殿之城》放映及导演见面会	文艺生活	北京
6.05咖啡课堂|教你制作一杯迷人的花式咖啡！	沙龙学堂	北京
【周末】相约玉渡山：寻找大自然最原始的绿色记忆	户外活动	北京
【国庆】体验石林峡宇宙之眼，走世界第一钛合金玻璃观景台	户外活动	北京
跟Deidre Wicks学呆萌的水彩插画	文艺生活	北京
『失贞』?胡大震 个人专场音乐会	暂不开放	北京
【周末】漫步神堂峪山水栈道，在山间野趣中自由穿行	户外活动	北京
做一个会做女红的女子 豪华晚宴包	DIY手作	北京
做个安静的美女子你还差一件旗袍	DIY手作	北京
古典音乐的语言――文学与音乐	沙龙学堂	北京
穿行老北京胡同，来一场说走就走的人文之旅（第2期）	户外活动	北京
玩嗨微电影-带你演绎一部黑帮喜剧	文艺生活	北京
5月29日周日：徜徉七孔桥花海，漫步碓臼峪山水，品尝农家春饼宴	户外活动	北京
日本生活近十年的老师带你日语入门，开启生活の新番！	沙龙学堂	北京
爱上苏绣―― 在传统中痴迷着喜悦	DIY手作	北京
解放小粗腿 藏肉显瘦必备半身蓬蓬裙	DIY手作	北京
2节课学会钢琴弹唱孙燕姿成名曲《天黑黑》	文艺生活	北京
7.9日周六：尽情畅游北方的小桂林”~易水湖	户外活动	北京
找到适合自己的妆容，发现适合自己的风格	文艺生活	北京
【住宿三晚-达里诺尔湖-乌兰布统】端午节驰骋塞罕坝草原风情摄影休闲游	户外活动	北京
[六一喜乐汇]	派对聚会	北京
【周末嗨一把】自由联想体验沙龙	沙龙学堂	北京
成人零基础形体芭蕾超值体验！优雅从现在开始！	文艺生活	北京
5.22花艺沙龙| 手工、变美两不误，花艺发饰DIY与编发的沙龙	DIY手作	北京
成人钢琴一次课教会你弹奏Big Bang的Loser	文艺生活	北京
《犴达罕》放映及导演见面会	文艺生活	北京
2016年5月20日－22日★ 五台山 （大五朝台路，五百年的修行）	户外活动	北京
你的专属形象课程---遇见未知的自己	沙龙学堂	北京
【手工皮具体验】植鞣染色零钱包	DIY手作	北京
5月28周六：北京的小九寨”玉渡山一日休闲活动	户外活动	北京
【讲座】周日 从寺观祠庙”谈起 ――到了寺庙要看啥	户外活动	北京
与你喜爱的电影人物，来场啤酒烤肉音乐派对	派对聚会	北京
北京|【红樽坊请您喝精酿啤酒！】	派对聚会	北京
北塘：北塘码头出海打渔 北塘古镇休闲行摄	户外活动	北京
用浪漫背心裙扮靓这个春天	DIY手作	北京
卿着一袭裙，秀色掩古今	DIY手作	北京
【我爱你】末小皮情歌专场	暂不开放	北京
【端午假期出行】乌兰布统草原--一个适合撒欢的地方	户外活动	北京
漫步神堂峪山水栈道，一日休闲踏青活动！	户外活动	北京
十渡东湖港登山赏瀑布、挑战玻璃栈道、玩江南竹筏，拒马河激情漂流！	户外活动	北京
"挑战世界第一的悬空钛合金玻璃UFO”观景台,带你玩心跳"	户外活动	北京
【零基础油画】教你把手机里的照片画下来	文艺生活	北京
Ulife设计漫谈丨什么才是好的包装设计？	文艺生活	北京
【今晚我们唱电视剧主题歌】晓月老板，晴朗，欧阳梦溪，Mr.Miss	暂不开放	北京
Ulife西餐料理丨奶油意面+金枪鱼三明治	派对聚会	北京
四合院里品茗论道，那些你不知道的红茶世界	茶会雅集	北京
5.15穿行老北京胡同，来一场说走就走的人文之旅	户外活动	北京
古筝速成班 女神养成记|  4节课学会2首古筝乐曲只需99元	文艺生活	北京
【音乐体验课】一节课学会尤克里里 小清新弹唱	文艺生活	北京
清除恐惧”工作坊	沙龙学堂	北京
数字节奏―架子鼓测评	文艺生活	北京
【Dimo音乐私塾】音乐弹唱交流会	派对聚会	北京
重磅推出魔力小上衣，让你轻松邂逅别样春天~	DIY手作	北京
周末下午茶――完美夏日的百搭半裙	DIY手作	北京
【情侣活动】―只属于我和你的双联画	DIY手作	北京
双井馆平日班课程 剑道初级课程体验	运动健身	北京
走进不一样的丹青之旅  零基础国画沙龙	沙龙学堂	北京
畅游石林峡，挑战世界第一UFO钛合金悬空玻璃观景平台！	户外活动	北京
『校园民谣弹唱会』主题专场?茶季杨	暂不开放	北京
5/14红樽坊初级品酒课――杯中的世界更精彩	文艺生活	北京
送给妈妈的祝福，你准备好了吗?	DIY手作	北京
Ulife设计漫谈丨如何设计出一款好Logo？	沙龙学堂	北京
五月十渡游：拒马河漂流，你敢来挑战吗？	户外活动	北京
喇叭沟门赏最美杜鹃花，看层林尽染，聆听白桦林的声音	户外活动	北京
【ME绘】油画4节课――学会四种油画技法	文艺生活	北京
夏天了，露肉之前你需要这样姿势的运动	运动健身	北京
樱花的水彩书签	DIY手作	北京
休闲时光，DIY意大利咖啡饼干	DIY手作	北京
DIY蔓越莓曲奇 美丽女人最爱	DIY手作	北京
缔造美丽、零基础DIY手工包包	DIY手作	北京
五一哪里去 低折优惠技能Get做美衣	DIY手作	北京
【赤橙第十一期预告】 相约五一画油画	沙龙学堂	北京
7月17日咖啡课堂|精品手冲咖啡体验：寻找你的手冲风味！	沙龙学堂	北京
亲手做个文艺范森女系布包	DIY手作	北京
五一假期：情绪减压”工作坊	沙龙学堂	北京
6.26咖啡课堂|带你玩转趣味咖啡杯测体验	文艺生活	北京
茉茉天空乐团 - 【平凡，特殊 mini音乐会】 嘉宾90Hz乐队	暂不开放	北京
【赤橙第十一期预告】五一相约朝阳门悠唐・画油画	文艺生活	北京
做件东方女孩儿不可缺少的旗袍	DIY手作	北京
钢琴弹唱 | 给我一首歌的时间  教你摇身变周董	文艺生活	北京
漫游十渡孤山寨，拒马河漂流（北京）	户外活动	北京
5.2晴朗?民谣女声专场	暂不开放	北京
『感受蓝调口琴魅力』布鲁斯口琴零基础体验课	文艺生活	北京
邂逅美丽！DIY无袖棉麻连衣裙	DIY手作	北京
爱自己，启动自我疗愈的能力	沙龙学堂	北京
【什院】最好的祝福―平安无事牌DIY制作	DIY手作	北京
端午假期，畅游山西「平遥古城-乔家大院-云冈石窟-北岳恒山-悬空寺」	户外活动	北京
现代钢琴10元体验明星课程	文艺生活	北京
畅游石林峡，挑战世界第一UFO悬空玻璃观景平台！	户外活动	北京
广弘明月|琴韵香风|4月30日香与琴的对话来啦	茶会雅集	北京
【五一】畅游山西大同3日游	户外活动	北京
北方张家界「天云山」，惊险刺激的悬空玻璃栈道等你来挑栈”！	户外活动	北京
【五一】轻装穿越库布齐沙漠，赏天下黄河老牛湾！	户外活动	北京
蓬莱长岛美丽摄影行	户外活动	北京
『一切尚好』刘润洁民谣专场 嘉宾：马潇 陈萝莉	暂不开放	北京
翻糖饼干DIY 美丽创意无限	DIY手作	北京
女神新技能你get了吗？	户外活动	北京
4.30-5.1房山十渡：漂流竹筏、烧烤激情2日游	户外活动	北京
畅游北方小乌镇-古北水镇，登司马台长城！	户外活动	北京
真人RPG游戏之星战・泰坦陨落	派对聚会	北京
成人钢琴独特方法体验课	文艺生活	北京
【中秋】轻装库不齐沙漠，感受大漠孤烟直	户外活动	北京
一针一线，乐在其中	DIY手作	北京
十渡孤山寨登山赏瀑布、划竹筏，挑栈”誓言悬空玻璃栈道！	户外活动	北京
清新裸妆生活妆容	文艺生活	北京
精油DIY体验・手工冷制皂	DIY手作	北京
Let's Italy!意大利风情尊享主题派对  美酒?美食?音乐?艺术【4/23 BJ】	派对聚会	北京
行走醉美南太行，郭亮村、云台山、挂壁公路	户外活动	北京
【赤橙第十期户外活动预告】北海公园户外零基础油画写生	文艺生活	北京
【五一】蓬莱-长岛・仙岛3日休闲游	户外活动	北京
你离春天只有衣布”之遥-半身喇叭裙制作	DIY手作	北京
民谣女声专场?王依妮，辉子，丁源	暂不开放	北京
制作100年永不变色的相框  只专属于你	DIY手作	北京
十里春风不如你穿的那件波西米亚半裙	DIY手作	北京
4月23日周六：相遇北方的乌镇-古北水镇	户外活动	北京
【城市派】手冲咖啡-品味属于自己的咖啡	文艺生活	北京
家门口的下午茶	文艺生活	北京
今夏不学 露肩杀 ”，怎么做时尚girl？	DIY手作	北京
茶味之初相，懂得茶艺之妙	茶会雅集	北京
在茶香中聆听暮春中茶与水的诗歌	茶会雅集	北京
时尚蕾丝旗袍，展现优雅自我	DIY手作	北京
周六游古北水镇北方小乌镇”观长城，赏夜景	户外活动	北京
7.03咖啡课堂|Latte Art意式咖啡拉花艺术初级体验课	文艺生活	北京
4.16 【门票半价】 白石山玻璃栈道等你来哦！	户外活动	北京
4月16日周六：神堂峪栈道，有山有水有美女，休闲徒步适合新人	户外活动	北京
【第九期预告】一花引万花开 纯油画体验	文艺生活	北京
零基础油画体验课，分分钟变画神！	文艺生活	北京
徜徉平谷最美桃花海，漫步金海湖赏湖光山色，一日休闲活动！	户外活动	北京
每周六晚调酒体验课，你来不来？	文艺生活	北京
零基础插花首选课，88元超值	DIY手作	北京
周六茶道共修	茶会雅集	北京
10月29-30日：夜爬泰山看日出，人间圣境观云海	户外活动	北京
这个周末，和小天使体验一份别致的时光吧	DIY手作	北京
夏日么么高冷冰咖	沙龙学堂	北京
【五一】轻装库布齐沙漠，老牛湾休闲游	户外活动	北京
新年给猴孩子一个惊喜	DIY手作	北京
成年人玩儿钢琴的地界儿~教你弹Eason的好久不见	文艺生活	北京
【齐开得圣】时下最热的活动――撕名牌大战半日活动	运动健身	北京
【五一】游苏杭：西湖、乌镇、西塘、拙政园★烟雨江南风光无限	户外活动	北京
Ar丨大型真人RPG游戏《迷境》星战系列之泰坦陨落	派对聚会	北京
手工万足银开口戒指体验DIY	DIY手作	北京
初夏の天空之城 | 零基础油画体验课	文艺生活	北京
油画 彩绘 零基础绘画 艺术礼物 画画体验课	文艺生活	北京
畅游黄花城水长城，登长城赏漫山遍野山桃花，看湖光山色！	户外活动	北京
烘焙Party----蓝莓奶酪派，美妙春气息	DIY手作	北京
特价门票！登北方奇山「白石山」，赏太行之首美景，玻璃栈道等你来挑栈”！	户外活动	北京
【城市派】享受一个幽静的时光，抹茶茶道精品教学	讲座沙龙	北京
徒步神堂峪山水栈道，一日踏青活动！	户外活动	北京
全国最长最宽的玻璃栈道・白石山	户外活动	北京
茶叶品评兴趣班	体验课	北京
静物?花系列 | 零基础油画专业指导	文艺生活	北京
四川禅游茶文化之旅 私人定制团招募	户外活动	北京
【爱布袋沙龙】沙盘游戏体验	文艺生活	北京
带着小U去撩妹，一小时学会ukulele	文艺生活	北京
古道寻花  ――桃花正当时，探寻原始的京西古道和人文村落	户外活动	北京
您想成为大明星 亲自参演一部网络短剧《腹黑先生》吗？	派对聚会	北京
侦探主题游戏| 《犯罪现场》	派对聚会	北京
【开课啦中医调理知识】摆脱春季过敏！大胆出去玩吧！	景区	北京
型男养成计划：健身教练为你私人订制「增肌」专项训练！	运动健身	北京
读书交流会《咨询室的秘密》	沙龙学堂	北京
德懋明前醉 清清茶香来 | 黄山净心之旅	茶会雅集	北京
【清明假期】4月4日黄花城水长城踏青赏花游	户外活动	北京
莫奈日出・印象 | 印象派油画临摹指导	文艺生活	北京
跆拳道也时尚，来自韩国的跆拳道教练	运动健身	北京
4+2来了！周末新玩法【自驾骑行】百里画廊	户外活动	北京
十渡农家院两日欢乐游	户外活动	北京
徒步南太行，逃票郭亮-罗姐寨-王莽岭	户外活动	北京
四合院里品茗论道，上一堂不一样的茶文化体验课	茶会雅集	北京
清明假期江南游，千岛剁田油菜花-扬州-乌镇，踏春三日休闲游！	户外活动	北京
【拿起来，放不下的乐趣】零基础初级彩铅课程	文艺生活	北京
一副油画迎接春暖花开	体验课	北京
女性魅力形象提升・一小时帮您发现最美的自己	沙龙学堂	北京
【端午】神奇原生态海岛游	户外活动	北京
5.1徒步京西古道，感受千年古风遗韵	户外活动	北京
奥森踏青，赏海棠花开 （北京）	派对聚会	北京
多出门 多聚会 容易遇到那个对的人	派对聚会	北京
北京安学堂  财商体验营	讲座沙龙	北京
复活节 | 爱上南半球的性感，新西兰葡萄酒专场品鉴会	讲座沙龙	北京
5节课 学会做咖啡	文艺生活	北京
一对一高级私人教练套餐课程	运动健身	北京
春纪 | 做一个弹琴的女子	文艺生活	北京
一年十次随心画―开心画画，开心做自己	文艺生活	北京
以茶之名――茶道体验课	茶会雅集	北京
静下心放慢生活|最珍贵的，莫过于这杯茶	茶会雅集	北京
那些你不知道的茶|茶文化入门体验	体验课	北京
带着画笔去旅行---零基础水彩技能GET！	体验课	北京
零基础油画DIY-油画系研究生带您感受油画魅力	文艺生活	北京
开心大作战 亲子足球一起嗨	运动健身	北京
顺平赏万亩杏林花海，登魅力陵山观满城汉墓！	户外活动	北京
登最美水长城，吃鲜香虹鳟鱼，偷得半日闲！	户外活动	北京
吉他零基础 一堂课教会你弹《嘀嗒》	文艺生活	北京
抄写经典 静心察己	沙龙学堂	北京
3.27葡萄酒课堂|葡萄酒基础品鉴与礼仪公开课	讲座沙龙	北京
香道共修-手工调制古法香方	体验课	北京
亲近自然-户外写生（周六）	体验课	北京
一场高雅的德州聚会・	派对聚会	北京
凯旋击剑体验课	运动健身	北京
尤克里里|一节课学会弹唱你喜欢的歌曲	文艺生活	北京
北方张家界「天云山」，特色悬空玻璃栈道等你来挑栈”！	户外活动	北京
【讲座】周六 揭秘中国古典家具的灵魂――榫卯结构	户外活动	北京
【五一】玩转平遥古城，乔家大院	户外活动	北京
减肥训练营！	运动健身	北京
花一点时间 ・ 遇见美好 | 郁金香・手提花篮与下午茶	讲座沙龙	北京
曹久忆?民谣专场	小型现场livehouse	北京
|手工皮具|街头达人最爱的剑桥包	DIY手作	北京
北海琴社?张子盛先生周四古琴入门班	暂不开放	北京
如何拥有真正的高情商	讲座沙龙	北京
燕猫艺筑首届少儿美术作品展之欣欣向荣”	展览	北京
《相约彼岸  春暖花开》―陈艳敏新书分享会	讲座沙龙	北京
北边的球友看过来，听说这里高手特别多	运动健身	北京
零基础成人钢琴梦从这里开始！	文艺生活	北京
3.12调酒课堂|燃烧的生命之水”Vodka-伏特加	讲座沙龙	北京
【城市派】世界那么大，我想听听你看到的世界。	沙龙学堂	北京
如何让自己的人生走上良性循环	讲座沙龙	北京
锦绣裁剪工坊 带你玩转缝纫机	DIY手作	北京
【闻香识酒】红葡萄酒香气大集结 感受杯中的那一抹香	派对聚会	北京
【失蜡铸造】作品展	展览	北京
准备好肾上腺素，京城最大鬼屋来袭！	派对聚会	北京
畅游香屯穿越京北大峡谷，一日休闲徒步活动！	户外活动	北京
平谷天云山：挑战玻璃栈道，挑战你的勇气	户外活动	北京
除了你， 一切繁华皆是荒芜	文艺生活	北京
想知道你的前世来生吗---量子催眠再次回归	讲座沙龙	北京
走进北方张家界，走玻璃栈道，看杂技歌舞表演	户外活动	北京
斑马春季周末市集	市集	北京
北京安学堂 说书会	讲座沙龙	北京
最美之约：清明节【库布齐沙漠】穿越扎营，看大漠孤烟直长河落日圆之美	户外活动	北京
真人RPG互动游戏|之三里屯拯救特工行动	派对聚会	北京
优雅?遇见～魅力女性形象提升课（让你由平凡到不凡）	文艺生活	北京
你与女神只差一堂课！	体验课	北京
妈妈的魔法，女儿的新衣！	DIY手作	北京
【周一】抄经，就这样心无挂碍	沙龙学堂	北京
北京单身白领联谊－下班相聚，因为爱情……	派对聚会	北京
悦读入门	讲座沙龙	北京
让您在钢琴中沉淀优雅	暂不开放	北京
教你用立裁设计制作条裙子 | 春暖花开的季节，把不同颜色穿在身上	DIY手作	北京
编条琉璃车挂祈福安	体验课	北京
我和春天有个约会！3.5来日坛迎春舞会逛市集	派对聚会	北京
蒙古 图利古尔 Tulegur?专场	小型现场livehouse	北京
【破冰价】流浪鼓手邀你共享非洲鼓魅力	文艺生活	北京
仙乐飘飘浪漫小提琴音乐派对	暂不开放	北京
清明节4.4日津门故里，百年天津卫”~天津休闲一日游	户外活动	北京
【周末半日】新学期攀新峰 室内攀岩半日活动	运动健身	北京
表演体验之2B or not 2B，解放自己的逗B天性！	派对聚会	北京
只要一个周末，就可学会一首古琴曲自由抚弦而歌	沙龙学堂	北京
【活动报名】品新酒，赢现金，来不来？	派对聚会	北京
当香料茶PK功夫茶	讲座沙龙	北京
资深咖啡人 jennifer带你 单品咖啡品鉴	沙龙学堂	北京
跟安德烈科恩学油画 | 撑伞的姑娘	文艺生活	北京
零基础棒球体验，春天就是要动起来！	运动健身	北京
动手做一条阔腿裤，你的春天最明媚	体验课	北京
北京沙龙 | 毕加索名画解析+临摹	派对聚会	北京
【入门级】零基础油画课程| 不是自助，是让你一次次进步	文艺生活	北京
韩国SBS御用造型师帮你变身韩剧女主	讲座沙龙	北京
仙乐飘飘浪漫音乐派对	音乐会	北京
【周日裸奔吧】第五届北京奥森光猪跑活动报名中	运动健身	北京
玉龙湾滑雪场全天不限时免费滑雪，快点来体验滑雪的乐趣吧！	户外活动	北京
【周四】一个动作，停下忙碌，感受生活的美好	讲座沙龙	北京
免票去最美的长城-慕田峪长城，赏冬去春来美景，一日徒步活动！	户外活动	北京
1对1声乐体验课，拯救五音不全的你！	文艺生活	北京
爱演的宝宝们，前方一场走心又高能的表演趴在正在@你！	戏剧	北京
赏龙庆峡冰灯，品特色豆腐宴，逛永宁古城，一日休闲游！	户外活动	北京
没有对抗的生活	讲座沙龙	北京
开酒啦！2月28日初春 做个品酒客！	讲座沙龙	北京
体验沙盘游戏心理疗法，享受三大环节极品沙龙	派对聚会	北京
多出门 多聚会   容易遇到那个对的人	派对聚会	北京
虚拟现实游戏《迷境》之三里屯解救特工行动	派对聚会	北京
送给宝贝一个美萌的冬天	派对聚会	北京
登最美水长城--黄花城.踏青赏春.品美味虹鳟鱼	户外活动	北京
白色情人节 做款半裙犒劳自己	体验课	北京
修习尺八需要耐住寂寞	文艺生活	北京
清明小聚？试试增强现实游戏《迷境》吧！	派对聚会	北京
3月27日，让我们优雅的做一个调酒师	DIY	北京
爆裂鼓手--带你了解节奏的世界	文艺生活	北京
香中自有美无涯 【周六香道体验】	派对聚会	北京
莫迪熊diy蛋糕6寸 装饰随心所欲	DIY手作	北京
白领还在咖啡馆品味优雅，精英们已经在[钢琴会所]沉淀优雅	暂不开放	北京
【爱对恋爱课堂】该选择爱你的还是你爱的？	讲座沙龙	北京
虚拟现实线下游戏《迷境》之三里屯特工解救任务	派对聚会	北京
爱对《手把手教你谈恋爱》	体验课	北京
七夕，第一次用一幅画，表达爱。	文艺生活	北京
「吉他弹唱，从零学起」50元超值音乐人精品课 ！	文艺生活	北京
红樽坊4月初级品酒课――品酒，没那么复杂	文艺生活	北京
萌萌的糯米糍来啦！	派对聚会	北京
新年太阳裙 必须猴起来	DIY手作	北京
春谣?大年初五~h霖专场	小型现场livehouse	北京
小普陪你过【情人节】	小型现场livehouse	北京
春谣?大年初三~李岩，嘉宾：Tony	小型现场livehouse	北京
【爱对・糖果果情感沙龙】每个女孩都是落入凡间的天使	讲座沙龙	北京
心理疗愈工作坊--疗愈不痛快的根源	派对聚会	北京
『尤克里里DIY打造一把温暖的琴』DIMO私塾春节迷你手工市集	DIY	北京
【春节】乌兰布统：2.9-2.12冬季到乌兰布统撒点野 越野车深度游行摄之旅	户外活动	北京
独享?摄影天堂壮美元阳梯田、罗平油菜花、东川红土地8日行	户外活动	北京
篆刻之美，方寸红白蕴古今	体验课	北京
莫迪熊马卡龙体验课程	DIY手作	北京
2016年春节期间，北京哪里有相亲会？	派对聚会	北京
亲手为自己做款燕尾裙 打造飘逸美感	DIY手作	北京
影视表演体验--集表演、拍摄、社交于一身	派对聚会	北京
社交圈：你好，陌生人！我想认识你单身交友活动！	派对聚会	北京
迎新春?佛语绵绵，素琴清声?那莲茶会	派对聚会	北京
【什院】最佳好礼―平安无事牌DIY制作	体验课	北京
1月31日，「魔幻塔罗单身精英交友派对」―开启你的命运之门！	派对聚会	北京
北京相亲会，单身交友聚会活动！	派对聚会	北京
时尚铅笔裙，hold住	户外活动	北京
这个新年 大衣就要这样穿	派对聚会	北京
线下趣味咖啡烘焙体验课：烘隆隆”咖啡都喝过，可未必都烘过！	文艺生活	北京
何为香事？许你一炉香，带你走进香的世界	茶会雅集	北京
老北京手艺・毛猴制作	DIY手作	北京
爱好服装的亲们！寒假班开课啦！	DIY	北京
你的天赋吸引力到底多少分|发展亲密关系必备测试	讲座沙龙	北京
新年开大招 高端美裙自己做	体验课	北京
零基础戏剧体验，让爱好更专业一点	派对聚会	北京
徐军?秦腔陕北民谣专场	小型现场livehouse	北京
夏墨手作”这里是，夏墨・石头记	DIY	北京
北京最好的单身Party--天降奇缘--遇见--TA（每晚不同主题活动）	派对聚会	北京
高端单身实名制交友聚会	派对聚会	北京
享受优雅高尔夫运动 超值4次畅打套餐	运动健身	北京
一起来做情侣心形裸蛋糕	DIY手作	北京
新年必入小红裙，那道靓丽的风景	户外活动	北京
古筝速学，一节课教你弹奏《菊花台》	文艺生活	北京
【夏墨手作】超可爱的手捧许愿瓶	DIY	北京
【北京靠谱单身】2016掐指一算，就差个对象了	派对聚会	北京
如何真正的从内心摆脱恐惧，把握好做事分寸	讲座沙龙	北京
拂衣委巷  书法基础体验课	文艺生活	北京
大牌小提琴带你零基础变身气质小提琴手	文艺生活	北京
Magic Garden 超值体验课――翻糖杯子蛋糕DIY	DIY	北京
【南瓜姑娘・美妆教学课】|如何定制属于自己的精致快手妆？	讲座沙龙	北京
苏绣初级课程（套课）--绣一方丝巾	DIY	北京
成人零基础古典舞”柔美身韵体验	文艺生活	北京
零基础不要怕 新年红裙炫起来	DIY	北京
不要带着自卑和痛苦去追求成功	讲座沙龙	北京
仙乐飘飘小提琴音乐主题派对	派对聚会	北京
造型大师・梓秋 带你穿越回民国	文艺生活	北京
跟Leonid Afremov学油画|绘一幅海边的渔船	体验课	北京
香道与古琴的对话	体验课	北京
【丘比特户外☆刺激系列】犬齿交错，狗牙间的舞蹈---周六狗牙山一日穿越队员征集令	户外活动	北京
英伦与布鲁斯~烯烯?民谣专场	小型现场livehouse	北京
2015不回头，2016不将就！80后专场单身交友聚会	派对聚会	北京
做双流苏耳环，宠爱你的耳	派对聚会	北京
画布上的星空 || 零基础绘画体验	体验课	北京
【爱情专列】――找到专属个人的爱情性格密码	讲座沙龙	北京
桃源仙谷徒步、登山、观奇景一线天、鸳鸯槐、看最壮观的瀑布【远离雾霾行动】	户外活动	北京
玩转麂皮风 穿出别样风情	派对聚会	北京
【东篱-中医】歧黄之术，中医国粹	沙龙学堂	北京
零基础素描，油画，彩铅，色彩，书法画画绘画体验课	文艺生活	北京
抄解心经 ● 品茶参禅	体验课	北京
在国家体育总局打羽毛球！	运动健身	北京
《彩虹伴我心》放映及导演见面	电影	北京
闻墨香 悟书法之道	讲座沙龙	北京
虚拟现实游戏《迷境》之蓝色港湾夺宝奇兵	派对聚会	北京
1月10日谢一源老师《面相识人》开课啦！	体验课	北京
了解声音特质 塑造嗓音魅力	体验课	北京
花很少的钱 师从钢琴大师 开启专业钢琴启蒙课	体验课	北京
琥珀鉴赏体验课 专业珠宝鉴定师教你实用妙招	讲座沙龙	北京
1对1私人专属吉他体验课！	户外活动	北京
Fun Job Art 零基础油画体验 75元 3折 价值249元	DIY	北京
新年抢好礼，29元演播厅学唱歌	小型现场livehouse	北京
新馆开业 剑道初级课程体验	运动健身	北京
最准MBTI测试：你和天生情人の蒙面约会	讲座沙龙	北京
太行山脉的璀璨明珠龙居冰瀑布”★郊外呼吸新鲜空气-登山摄影一日活动！	户外活动	北京
拂衣委巷 国画 工笔 绘画 画画体验课	文艺生活	北京
床边油画系列 | 奈良美智的48个女孩	体验课	北京
新年陶艺课程预告||零基础手作&DIY家居饰品	体验课	北京
【小马户外】元旦01月01/02/03日三期连发：石京龙滑雪场激情滑雪，玩转假期~	户外活动	北京
【城市派12.31周四】2015~2016跨年夜大趴体	派对聚会	北京
三分钟做美裙，今年必备大招！	DIY	北京
【提升爱的能力】情感大师赵永久经典讲座	讲座沙龙	北京
跟Janet hill学油画‖暖暖的复古女孩	体验课	北京
【丁源?孙亮】陪你过圣诞节~嘉宾：谁谁	小型现场livehouse	北京
暖心冬日，亲手做一个姜饼屋	DIY	北京
冬季圣诞主题剪纸DIY	DIY	北京
换书派对，分享你书本中的精彩	派对聚会	北京
【十八字金】亲手做枚银戒送给Ta，手作一枚有温度的银饰！	DIY手作	北京
寻一次冰瀑之旅，走一程桃源仙谷一日活动	户外活动	北京
你比你所能想像的更美--打造独一无二适合你的风格	体验课	北京
高端心理讲堂：知识分子为何更容易神经衰弱和抑郁	讲座沙龙	北京
9.9抢价值999元新年音乐会门票 数量有限 先到先得呦！	音乐会	北京
随便玩走进山西乔家大院 夜游平遥古城 感受千年历史文化	户外活动	北京
精致生活别忘了给自己做个晚宴包	DIY手作	北京
冬天最爱英伦风 | 教你做件英伦小斗篷	DIY手作	北京
快过年了，一起来种点肉吧	体验课	北京
木盒鲜花DIY体验课	派对聚会	北京
看京北最壮观的冰瀑群--桃源仙谷登山-摄影-拍冰瀑	户外活动	北京
高端心理讲堂：如何由内而外的自信起来	讲座沙龙	北京
高端心理讲堂：把生活中的危机”转化成急剧成长的契机	派对聚会	北京
与潜意识对话：照见自己的内心世界 ――停下来，走走心，探索真实的你自己	体验课	北京
漫步北京最美瀑布群「桃源仙谷」，赏最美冰瀑、冰潭、冰湖	户外活动	北京
形象设计一对一课程	沙龙学堂	北京
【圣诞节】冬日梦幻高逼格大龄男神女神趴	派对聚会	北京
【两性关系心理沙龙】提升婚恋幸福能力	讲座沙龙	北京
把时间和温度投注在一件大衣上	DIY	北京
锋味第四局|12月13日女神的新衣”香槟起泡酒专场	派对聚会	北京
圣诞姜饼屋体验课	派对聚会	北京
如何利用好家里的手机、相机、单反相机记录家庭生活中的美好瞬间	派对聚会	北京
性福女人沙龙	沙龙学堂	北京
青年导演短片展及映后讨论	电影	北京
东篱?篆书篆刻学习	体验课	北京
咪咪乐队12月5日演唱会	演唱会	北京
轻抚七弦古琴 体验古之文人雅事	讲座沙龙	北京
二把刀的心理咨询从业体验 ――3L教练技术看咨询督导	讲座沙龙	北京
蕾丝小黑裙―小黑裙的升级版	户外活动	北京
精致生活 3小时教你学会化妆	文艺生活	北京
吉他、尤克里里冬季暖心1元体验课	体验课	北京
石京龙滑雪场全天不限时特价滑雪，快点来体验滑雪的乐趣吧！	户外活动	北京
享受拥有钢琴和陪伴的下午茶时光 | 包教会一首钢琴曲哦	文艺生活	北京
畅游北京最近沙漠「天漠」，品特色豆腐宴，逛永宁古城	户外活动	北京
【东篱-书法】挥毫落纸如云烟	文艺生活	北京
周末下午茶――服装手工diy小香风半裙	DIY手作	北京
品味别致生活，挎出别样风采	DIY手作	北京
狼牙山滑雪场全天不限时特价优惠滑雪！只限本周！	户外活动	北京
冬季里暖心的吉他情歌--1元体验课	暂不开放	北京
赶走低落--拥抱快乐心理体验沙龙	派对聚会	北京
1节课教会你弹唱宋冬野《斑马》	沙龙学堂	北京
1元活动”下雪了.跟【人人往艺】给手机安个暖暖的家	体验课	北京
【东篱书院】帝王之学，奇门遁甲	沙龙学堂	北京
珍珠项链/银饰项链DIY：自己动手制做感恩节礼物吧	DIY	北京
为自己缝一款包包	DIY手作	北京
让你在游戏中学习成为谈判高手！	沙龙学堂	北京
你与时尚只有一步的距离！	体验课	北京
【丘比特户外☆静默之旅】门潭古道-潭柘寺穿越☆静默☆之旅，感恩之行	户外活动	北京
跟【人人往艺】一起做锦囊	体验课	北京
精油轻美容护理：女人的幸福，与爱情无关，与颜值有关！	购物	北京
◆周六下午紧急加场◆大山中文脱口秀专场11月21日16:30加演 幽默小区脱口秀俱乐部出品	戏剧	北京
童年创伤对择友的影响――恋爱心理沙龙	讲座沙龙	北京
一起寻找你的咖啡玩法――意式咖啡制作-拉花体验	文艺生活	北京
48元，两节课，包会三首钢琴曲	文艺生活	北京
银饰DIY订制，11月特惠，仅限7天，买一送一！	DIY	北京
墨西哥导演Pablo Mendoza短片展映及Q&A	电影	北京
想脱光”跟我来！亲和力玉渡山之旅双十一交友活动招募令	户外活动	北京
说出你的故事感恩节特辑《我们一起说谢谢》	派对聚会	北京
习书静心	体验课	北京
1元活动” 做个耳机包&零钱包，钥匙扣	体验课	北京
12/12红樽坊初级品酒课――看看葡萄酒的气质	体验课	北京
11/08 深秋私房品酒午餐，齐少带你找回心中的小王子	派对聚会	北京
脱单”给自己的礼物---亲密关系情感沙龙	派对聚会	北京
『心碑』张浅潜	小型现场livehouse	北京
京西小九寨--双龙峡，坐小火车赏秋色（免费赠送小火车票）	户外活动	北京
晴朗?女声民谣专场弹唱会	小型现场livehouse	北京
传统不一定代表不了时尚	户外活动	北京
教你DIY太阳裙	DIY	北京
俩分钟教你做一件百搭小上衣	DIY	北京
四季市集一周年派对！！！	市集	北京
北京正规实名高素质相亲，单身交友聚会！	派对聚会	北京
国色天香 | 国画工笔花卉 零基础体验	体验课	北京
【光棍节】北京高品质男神女神趴	派对聚会	北京
古琴学习初基班.东篱书院	体验课	北京
【丘比特★我爱大片】11月7日门潭古道穿越，潭柘寺银杏节	户外活动	北京
【周二暴走】本年度最后一期~面向所有小伙伴发起【快乐见证者】召集令	户外活动	北京
万圣节下午：如何找到你的理想爱人――恋爱心理沙龙	派对聚会	北京
行尸无惧！万圣节化妆趴精彩倒计时！怎么HIGH怎么来~	派对聚会	北京
手工烘焙―萌萌哒亲子手工翻糖饼干	DIY	北京
现金流游戏|两小时游戏演绎人生四十年	派对聚会	北京
换书沙龙，交换我们心中的玫瑰	派对聚会	北京
玩OH卡牌 | 探索自己，解决疑问	沙龙学堂	北京
【亲，和你们负责人谈过了。这样的低价活动咱们不上了哈，只上高品质的优秀的活动哦】	派对聚会	北京
羽毛球正当时，玩的不是球，是快乐	运动健身	北京
传统也可以很时尚，每个女人衣橱里都应该有一件旗袍	户外活动	北京
【11・1周日】小光~棍节――男神&女神超能战队大PK~带你玩转金秋银杏林	户外活动	北京
山楂树的爱情离我有多远---亲密关系心理体验沙龙	派对聚会	北京
28天改变你的生活 | 发现你的天赋优势	讲座沙龙	北京
畅游龙门飞甲拍摄地「天漠」，品特色豆腐宴，逛永宁古城	户外活动	北京
射箭是对生活的一种态度	运动健身	北京
10/27 霍克斯湾经典――威杜（Vidal）庄园品鉴会	派对聚会	北京
【吃货福利】味道西单?乐在西城?西单水彩私家烤鱼体验	DIY手作	北京
醉美晚秋「坡峰岭」，赏漫山遍野红叶，层林尽染	户外活动	北京
第一期【周末高端单身交友舞会】仅剩6个名额	派对聚会	北京
【周日观影】主题系列――爱情三部曲之《爱在黎明破晓前》	派对聚会	北京
【周五闪玩】最后的我们――密室逃脱极致体验	派对聚会	北京
走进京西小九寨-【双龙峡】-坐小火车 赏红叶 观赏百潭瀑布	户外活动	北京
用插花的方式走进梵高的世界|梵高的花园”花艺沙龙	DIY	北京
侦探主题游戏《犯罪现场》	派对聚会	北京
朝闻白玫瑰 夜饮红玫瑰―夏洛的烦恼与抉择	派对聚会	北京
"私人形象设计之美妞养成季―1小时学会化妆服装搭配,妆出美！穿出范儿"	派对聚会	北京
醉美金秋喇叭沟门，登南猴顶，漫步白桦林枫叶林赏秋色	户外活动	北京
北方张家界「天云山」，悬空玻璃栈道等你来挑栈”！	户外活动	北京
找到最好的恋人――恋爱心理讲座	讲座沙龙	北京
【周五闪玩】美酒美食与酒吧，趁着夜色，我们一起高调做坏事吧	派对聚会	北京
终于盼来国庆假期！抓紧时间找对象喽！	派对聚会	北京
一场高雅的德州聚会	派对聚会	北京
挥舞灵动的沙	派对聚会	北京
微醺之美--触摸鸡尾酒心脏Gin”	派对聚会	北京
利用超轻粘土制作各种玩偶；发挥你的想象力一起捏捏吧！	DIY手作	北京
『水之都』佳妮?音乐会	小型现场livehouse	北京
【时尚鸡尾酒之龙舌兰专场】调出属于自己的神之杯--Tequila	DIY	北京
【城市派 周六】手冲咖啡-品味属于自己的咖啡	DIY手作	北京
"私人形象顾问打造你的\""女神范儿\""―让这个\""城\""，\""配\""得上你的「美」！"	体验课	北京
让你在游戏中学习――成为谈判高手！	派对聚会	北京
【1元公益】城市\\微旅行――皇城根儿之天安门西-南北长街-角楼-中国美术馆-三联书社	文艺生活	北京
【1元公益】城市\\微旅行――感受胡同风情之前门-杨梅竹胡同-鲜鱼口街	文艺生活	北京
【城市派9.30周三】享受一个幽静的夜晚，抹茶茶道精品教学	讲座沙龙	北京
召唤你的生命原型，唤醒你的生命能量	讲座沙龙	北京
【城市派9.29周二】禅境花园升级版，感受禅文化的博大	派对聚会	北京
【城市派周六】理财桌游，两小时游戏演绎人生四十年	派对聚会	北京
【10.11周末观影】观影达人带你走进尼泊尔――《等风来》	电影	北京
中秋节去哪儿？单身之家邀你团圆啦！北京正规实名相亲聚会	派对聚会	北京
叁才女『晴朗?王依妮?丁源』陪你过【中秋】	暂不开放	北京
【9・27中秋相约】美食、老公园和中秋夜色的合体，中秋我们拒绝一个人~	派对聚会	北京
【中秋佳节】DIY冰皮月饼+甜点+咖啡等你来品尝	DIY手作	北京
十一国庆长假 【卧铺】畅游西北（额济纳、青海湖、茶卡盐湖、敦煌莫高窟）	户外活动	北京
十一欢乐行 剪出来的艺术-传统剪纸体验	体验课	北京
15分钟教你做一件欧美半身蓬蓬裙高腰	文艺生活	北京
包制百病”：自己来做包包啦	派对聚会	北京
【9月20日・周末观影】相约巧克力女孩――让我们一起闻香识女人”！	电影	北京
【09・26公益活动】爱心采摘，太阳村葡萄采摘节	文艺生活	北京
9月27修心品茶雕莲蓬（玉雕系列课程之入门课）	体验课	北京
博物馆里迎中秋--手绘兔爷不简单	DIY	北京
【9.20周日】逛&吃~逛&吃~周周美食会来啦！	DIY手作	北京
【丘比特★我爱登山】9月19日、挑战北京最高峰（2303米）――东灵山，欢迎参加！	户外活动	北京
【丘比特★我爱行摄】9月19日 花海漫游，延庆珍珠泉、四季花海、一日赏花休闲行摄活动	户外活动	北京
必不可少的斗篷	派对聚会	北京
【1元公益】城市\\微旅行――探索胡同文化之雍和宫-国子监-五道营老胡同	文艺生活	北京
居合道炫酷体验「一击必杀」的快感	运动健身	北京
【玉渡山】 高山草坪、香闸瀑布 、百蝶泉、一日休闲摄影活动	户外活动	北京
玻璃瓶里的绿野仙踪 -- 微景观DIY	DIY手作	北京
【相约奥森】一场有预谋的不期而遇，是一见如故？还是久别重逢？	派对聚会	北京
【周末观影】为你，千千万万遍！”――《追风筝的人》	电影	北京
刀光剑影，谁输谁赢？剑道课让你感受不一样的周末！	运动健身	北京
【1元公益】奥森暴走强势回归――荧光暴走重磅来袭！	文艺生活	北京
辽宁绥中止锚湾・清凉一夏海边，戏水，拾贝壳捡海星，抓螃蟹，免费看日出	派对聚会	北京
职场社交沙龙―想有范儿，来学学商务接待礼仪吧	讲座沙龙	北京
【1元公益】城市\\微旅行――寻找老北京的记忆・什刹海	文艺生活	北京
中秋月又圆，DIY冰皮月饼来团圆	DIY手作	北京
卡坦岛：带你玩儿一款从你小时候一直火到现在的游戏！	派对聚会	北京
梦马乐队 Blues 专场	暂不开放	北京
『一小时学古琴』《佳人曲》《沧海一声笑》《仙翁操》任选	文艺生活	北京
身心灵沟通沙龙｜每个人在世界里都是独一无二的	沙龙学堂	北京
胜利日假期：畅游平遥古城&乔家大院&云冈石窟&悬空寺&北岳恒山	运动健身	北京
体验「剑道」，开启正能量之旅	运动健身	北京
精油DIY体验课：回归最初的自然，再贵的护肤品也不如自己亲手调制的安全	购物	北京
胜利日假期：醉美红海滩&神奇天路笔架山&山海关&老龙头	运动健身	北京
体验乐器之王”――钢琴	暂不开放	北京
亲手缝制太阳裙	派对聚会	北京
胜利日假期：相约美丽山东「长岛」「蓬莱」	运动健身	北京
来「鼓岛」遇见更有趣的自己  让有限的生命躁起来！	暂不开放	北京
冬天也要穿得美美哒，动手为自己做件连身裙	派对聚会	北京
香屯 ・大云峡谷・水泉沟徒步一日游	派对聚会	北京
【魔族户外】老龙窝-东湖林穿越-乌金之路-龙头聚首	运动健身	北京
技能进阶| 近景魔术普及教学沙龙	派对聚会	北京
涂色大神在召唤，《秘密花园》揭秘！	派对聚会	北京
「红樽坊初级品酒课」唤醒你的嗅觉与味觉	讲座沙龙	北京
亲手做一块手工皂，进口精油，无添加，让肌肤更健康	派对聚会	北京
【1元体验】胡同里的悠闲绘画生活！	派对聚会	北京
百花山上百花香，赏花看云听风响	派对聚会	北京
1节课教会你吉他弹唱《奇妙能力歌》	文艺生活	北京
周末两天相约丰宁坝上草原，醉美闪电湖、大汗行宫，免费烤羊篝火许愿灯	运动健身	北京
畅游「四季花海」，薰衣草&向日葵园&珍珠泉&永宁古城，一日游！	运动健身	北京
玉壶瓶里绘丹青 ――93号院博物馆内画鼻烟壶艺术体验活动	展览	北京
寻爱?会爱系列：如何遇见属于你的幸福	派对聚会	北京
【胜利日】9月2日-5日达里诺尔湖、锡林郭勒草原天堂、勃隆克玉龙沙湖3天梦幻之旅	派对聚会	北京
5分钟做出经典衬衫，出门就要美美的	派对聚会	北京
理财桌游，看看未来你会成为有钱人吗？	派对聚会	北京
零基础油画课程｜从临摹大师作品开始 油画、素描、水彩、色彩	文艺生活	北京
两位缠丝大仙下凡 邀你品茶一叙：缠丝戒指DIY	派对聚会	北京
侦探主题游戏「犯罪现场」・寻找福尔摩斯	派对聚会	北京
「育泰击剑」击剑――离你并不遥远！！	运动健身	北京
京西小桂林・十渡孤山寨，踏青、漂流戏水、观瀑布、清凉一夏！！	派对聚会	北京
无用｜息目以聪耳，一部用耳朵看的戏剧	戏剧	北京
萌妹称霸朋友圈：立体刺绣――金蝶	派对聚会	北京
DIY冰皮月饼又来啦～提前感受中秋的团圆氛围吧！就差你啦！	派对聚会	北京
东篱?古琴共修	派对聚会	北京
Comedy Club China Presents Stand-Up Comedy	戏剧	北京
海坨山看日出云海，户外露营大趴！	派对聚会	北京
情定五台山.免票穿越.看日出，沿途赏美景	派对聚会	北京
戏剧舞台初体验| 来初台，一起品尝「爱情麻辣烫」：	派对聚会	北京
涂色，《秘密花园》揭秘！――飞乐鸟的涂色解密课	派对聚会	北京
当迪伦.Dylan遇上科恩.Cohen――老刘/王壹：经典翻唱夜	派对聚会	北京
「不一样的成长」找回快乐的自己―康老师雪山归来分享会	派对聚会	北京
手工皮具初级课程――一枚折叠零钱包（毛面毛边处理篇）	派对聚会	北京
五周年庆典！100元畅饮！The V吸血鬼酒吧喝起来~	酒吧	北京
与「蓝胖子」一起私奔到童年――陶艺体验	DIY手作	北京
最贴心的礼物莫过于亲手DIY的生日蛋糕	DIY手作	北京
七夕之夜，在土耳其的异域风情中邂逅女神	派对聚会	北京
专属瓷器：最美不过釉下彩	派对聚会	北京
【学院路】古典油画人像课程	派对聚会	北京
塞上江南：十渡「孤山寨」，竹筏戏水，拒马河漂流！	派对聚会	北京
陶艺泥塑体验 | 动手捏个礼物送给TA吧	DIY手作	北京
三分钟学会做裙子	派对聚会	北京
Event | Lean in Beijing 夏日电影・Series 2《蒙娜丽莎的微笑》放映与研讨	电影	北京
塔罗守护排阵：遇见并Hold住属于你的幸福（首排试听）	讲座沙龙	北京
『兴趣大抉择之无人机』尚技教室，邀你来上课啦~	派对聚会	北京
最好的七夕礼物在这里----亲手为TA做一件情侣装	派对聚会	北京
「艺术家告白第二期」谭平--时间与空间	派对聚会	北京
周日晚 | 潜意识之海：通过心理游戏洞见你的人际互动模式	派对聚会	北京
只要1元就可以体验各式街舞，心动吗？	派对聚会	北京
「特价学技能」涂色已经过时，我们一起来画水粉吧~	派对聚会	北京
精油DIY体验课：回归最初的自然，再贵的护肤品也不如自己亲手调制的安全 ~	派对聚会	北京
午后时光 邂逅红酒―原装进口葡萄酒品鉴会	派对聚会	北京
咖啡沙龙，来认识一下手冲咖啡的渊源	派对聚会	北京
嵌上你名字的彩色名片夹――手工皮具体验课	派对聚会	北京
零基础油画、创作、临摹 「梵高～盛开杏花」	派对聚会	北京
1节课教会你弹唱《南山南》	文艺生活	北京
东篱?手工共修	派对聚会	北京
「周六跟队自驾」千里江南近在北京---江南古北水镇一日游	派对聚会	北京
杨凌雁?钢琴弹唱会	暂不开放	北京
东篱?「周易」命理共修	派对聚会	北京
微景观的diy 瓶子里的大畅想	DIY	北京
东篱 ・篆书篆刻共修	派对聚会	北京
北京最美乡村香屯―水泉沟―京北大峡谷，观古长城，感受山谷间纯净的美	派对聚会	北京
9.13 | 酒中贵妇”香槟专场&酩悦香槟品鉴会	派对聚会	北京
周日爱琴海体验・化百炼钢为绕指柔的艺术	派对聚会	北京
读书人的狂欢：当读书会遇到爵士乐	派对聚会	北京
东篱 ・周日「古琴」共修	派对聚会	北京
北方张家界「天云山」，全国最长玻璃栈道等你来挑栈”！	派对聚会	北京
畅游世界三大古海岸湿地之一的「七里海」	派对聚会	北京
来听听不一样的声音：藏族民谣歌手次仁罗布	暂不开放	北京
杰森来了！撕名牌新主题「黑色星期五」暑期来袭！	派对聚会	北京
坝上草原、骑马、日出、篝火晚会、烤全羊	派对聚会	北京
华北明珠「白洋淀」，赏千亩荷花大观园，坐船穿芦苇赏荷花	派对聚会	北京
奔跑吧兄弟拍摄地「古北水镇」：塞上江南，北方小乌镇，一日游	派对聚会	北京
零基础油画创作&临摹 【当代油画―星空】	派对聚会	北京
树子2015全国巡演北京站	暂不开放	北京
团扇上的浮世绘：最耐人寻味的「邪与媚」	派对聚会	北京
电脑还可以这么玩，给小朋友的Scratch创意编程试听课~	派对聚会	北京
烘焙入门：一对一教你做饼干	DIY手作	北京
夏日「时尚鸡尾酒」之伏特加	派对聚会	北京
天津七里海 世界三大古海岸湿地观鸟、行摄、漫步芦苇荡，美食分享会~	派对聚会	北京
草原天路、塞北梯田、露营休闲游	派对聚会	北京
天云山「挑战千米玻璃栈道」「高空走钢丝」「少数民族歌舞表演」「美食分享会」	派对聚会	北京
儿童绘画体验课 专业教师授课：让童年充满色彩	派对聚会	北京
刘冬虹?专场	暂不开放	北京
跟队自驾|京北一漂激情漂流+自助烧烤一日游	派对聚会	北京
11月1日!「时尚鸡尾酒」之威士忌课程	派对聚会	北京
着汉时裙裾，琴筝在御~	暂不开放	北京
国艺雅乐 古琴文化深度体验~	暂不开放	北京
「玩美手工」周日一起来玩衍纸吧	派对聚会	北京
「仅限15人」北京红樽坊初级品酒课，教你如何品葡萄酒（需预约）	派对聚会	北京
The Black Hipster蓝调音乐会	暂不开放	北京
吉他、尤克里里的初体验~	暂不开放	北京
"咖啡品鉴,因为有味儿，所以才咂么！让舌头来此愉悦的SPA！"	派对聚会	北京
未成年空手道体验|从小就学空手道，长大肯定棒棒哒	运动健身	北京
致青春 | 从学院路到三里屯”小聚，我们一起来追回校园生活	派对聚会	北京
剪一段美的时光 做一件心仪的霓裳	派对聚会	北京
夏日避暑！周末相约「翡翠岛」：海水与沙漠的吻痕，游泳冲浪露营BBQ！	派对聚会	北京
周日请帖・ 夏日甜品嘉年华！一起来赴这场属于吃货的盛宴~	DIY手作	北京
一花一世界，一叶一菩提~	派对聚会	北京
准备好你的肾上腺素，京城最大鬼屋震撼来袭！（胆小勿看）	派对聚会	北京
天云山「挑战千米玻璃栈道」「美食分享会」「高空走钢丝」「少数民族歌舞表演」	派对聚会	北京
可休闲・可摄影―北京十大幽静清新地野鸭湖、古崖居等你来	派对聚会	北京
西藏之声?次仁罗布	暂不开放	北京
Hi!激情而热烈，白兰地鸡尾酒课程	派对聚会	北京
京郊世外桃源「后河」：戏水、抓虾、捞鱼，尽享夏日清凉	派对聚会	北京
用自己做的花器体验一次花艺	DIY	北京
日本小原流花道：据说精致生活的人都爱它	派对聚会	北京
十渡「孤山寨」，竹筏戏水，拒马河激情漂流！	派对聚会	北京
慕田峪穿越村里上山 ・ 慕田峪最高点一日登长城、摄影	派对聚会	北京
佳妮?民谣爵士专场	暂不开放	北京
周六，来一场刺激的Fencing party吧！（最后一张女士票）	派对聚会	北京
「不一样的成长」 心理体验沙龙	派对聚会	北京
（相同活动，请勿重复提交）本周末，让我们一起画画吧！零基础绘画沙龙	派对聚会	北京
洞箫共修	暂不开放	北京
38元学会两首钢琴曲，用指尖触动心灵	暂不开放	北京
史航x石述思：英雄解构对碰主流价值观？文艺创作的边界在哪里？	派对聚会	北京
黄金海岸翡翠岛露营自助烧烤（面朝大海 免费提供装备）	派对聚会	北京
型男养成计划：健身教练为你私人订制「增肌」专项训练	运动健身	北京
感受木艺之美：木艺微缩体验邀您参加	派对聚会	北京
儿童马术快乐体验・让TA做一个快乐的小骑士	运动健身	北京
技能GET: 带你「读」成沙盘游戏咨询师	派对聚会	北京
3D卡通曲奇饼干DIY，满满乐趣和情意	DIY手作	北京
量子催眠之旅 回溯前世和未来	派对聚会	北京
选一个安静午后，做一袭棉麻衣裙	派对聚会	北京
东篱・京剧共修	戏剧	北京
一场关于摄影的分享交流会	派对聚会	北京
『あいうえお』民谣大趴儿	暂不开放	北京
和小伙伴一起来体验蛋糕烘焙的乐趣吧	DIY手作	北京
雕刻时光，手作之美：你拥有的独一无二的时尚	DIY手作	北京
天云山「挑战千米玻璃栈道」「美食分享会」「高空走钢丝」「少数民族歌舞表演」~	派对聚会	北京
心理学| 用一粒沙，让你们更亲密！	沙龙学堂	北京
生存技能加一： 防身术空手道元融武道小班课	运动健身	北京
这个夏天，激情而热烈，龙舌兰鸡尾酒	派对聚会	北京
「纸」说 ： 来和我谈场恋爱吧	派对聚会	北京
「占星沙龙」走进冥王星：直面心底最深切的欲望与恐惧	派对聚会	北京
健身教练为你私人订制，三分练七分吃，我要的不是瘦而是线条！	运动健身	北京
胡xsusu『夏日夜』弹唱会	暂不开放	北京
轻户外|与「云峰山」的不老约定―薰衣草园的花语世界，森林树屋的童话幻想！	派对聚会	北京
瑞典独立唱作人Adam Evald + 圣彼得堡艺术家Masha Bende	暂不开放	北京
吉他弹唱公开课----《平凡之路》	暂不开放	北京
「天津盘山」周六逃票穿越，乾隆爷去过32次的地方！早知有盘山，何必下江南	运动健身	北京
蘑菇之夜：于思&徐菲「阿比鹿最受欢迎新人奖」	暂不开放	北京
「每周技能」修身养性，书法、国画深度体验	派对聚会	北京
杯子蛋糕饼干特惠套餐 一次课程两种体验	DIY手作	北京
关于「射箭」，还可以再性感一点吗	运动健身	北京
白河峡谷捧河湾「捉虾捞贝壳」「千尺瀑」「美食分享会」休闲戏水！	派对聚会	北京
白河漂流，京北第一漂，激情夏日湿身之旅	派对聚会	北京
海盗来袭！带你玩一场带剧情的撕名牌「海盗纪：诅咒的金币」	派对聚会	北京
女神季进化论| 私人形象顾问1小时教会你化妆、服装搭配	派对聚会	北京
烘焙入门体验  手把手教你做杯子蛋糕	DIY手作	北京
「健身私教一对一」反手摸肚脐算什么，马甲线才是王道，你的身体是一切美好的开始	运动健身	北京
丰宁坝上草原、醉美闪电湖：看日出・骑马・免费吃烤全羊・篝火・卡拉OK	派对聚会	北京
教会你想学的那一首歌	暂不开放	北京
激情夏日，「时尚鸡尾酒」之白兰地	派对聚会	北京
零基础水彩画，画什么可以随便选哦~	派对聚会	北京
拼布之机缝小包	派对聚会	北京
周末相约「翡翠岛」：海水与沙漠的吻痕，清凉一夏，游泳露营BBQ！	派对聚会	北京
叮叮当当听风之语：DIY手工「江户风铃」	派对聚会	北京
大傻子唱片・纣王&李晋「鸡汤」全国巡演	暂不开放	北京
来吧，篮球	运动健身	北京
白云峡谷、捧河湾、溯溪拾贝、摄影、小穿越！	户外活动	北京
一起来看恐怖片	电影	北京
9.9元体验|空手道，想要成为黑带？从这里开始	运动健身	北京
养一盆花 饲一缸鱼 爱一个人 微景观DIY体验	DIY	北京
逛山间白桦林，山顶栈道上望远山，百花山上拍大片	户外活动	北京
电影沙龙，邀你踏上疯狂麦克斯狂暴之路	电影	北京
「零基础」教你亲手手绘一件飘逸的亚麻衣衫	派对聚会	北京
「零」基础成人击剑公开课	运动健身	北京
奔跑吧觅之境之「大山深处的秘密」	派对聚会	北京
京城最大鬼屋震撼来袭！抉择惊悚体验馆！	派对聚会	北京
「每周技能」弹吉他？只要会这一首就足够了---《匆匆那年》	派对聚会	北京
塞上江南：十渡「孤山寨」，竹筏戏水，拒马河激情漂流！	派对聚会	北京
OURWEEK绘画沙龙|零基础绘画体验	文艺生活	北京
东篱?茶道共修	派对聚会	北京
时尚鸡尾酒之威士忌	派对聚会	北京
「每周技能」着汉时裙裾，琴筝在御	派对聚会	北京
来一场苏绣体验吧！	派对聚会	北京
「每周技能」泥巴达人，来捏一堆蓝胖子”表情包！	派对聚会	北京
油画与红酒，你这个周末我包了~	派对聚会	北京
一元体验|揭开肚皮舞的神秘面纱	运动健身	北京
「父亲节」礼品花花艺沙龙	派对聚会	北京
「烘隆隆」咖啡都喝过，可未必都烘过！咖啡DIY，制作有你味道的咖啡礼品	派对聚会	北京
张佳迪 & Dimo独立乐团|民谣爵士专场	暂不开放	北京
「我家大树会开花」JORAM押花下午茶父亲节专场！创意嘭嘭嘭千万别错过！	派对聚会	北京
北塘邮轮出海，打渔摸虾，海鲜宴走起，皮皮虾肥美季节不能错过！	派对聚会	北京
蜗牛de家4周年?丁源~专辑首发	暂不开放	北京
夏末最后一次手绘团扇体验活动	派对聚会	北京
蜗牛de家4周年?Mr Miss 流行爵士专场	暂不开放	北京
自助画社| 体验大师的风采，送你不一样的玫瑰花！	派对聚会	北京
东篱・书法共修	派对聚会	北京
东方有腔调，茶DIY| 当中国茶遇到外国茶	派对聚会	北京
「每周技能」无人机时代，站在上帝视角”看世界	派对聚会	北京
牛de家4周年 ・ 晴朗女声民谣	暂不开放	北京
夏日避暑好去处，玩京北漂汤河漂流，游山水湖景雁栖湖	派对聚会	北京
亲手做件舒服的亚麻衣衫给爸爸妈妈	派对聚会	北京
「中国众神」讲座，领略中国神话的魅力	派对聚会	北京
丰宁坝上草原、大汗行宫、闪电湖巴士二日游	派对聚会	北京
东篱・中医脉诊共修	派对聚会	北京
美味自己做，开心看得见|周末做个披萨吧	DIY手作	北京
「每周技能」花开初夏，在花艺中感悟生活的诗意与美---零基础花艺体验课	派对聚会	北京
还为不知道如何穿衣烦恼吗----改变形象服饰搭配沙龙讲座	派对聚会	北京
东篱 ・ 篆书篆刻共修	派对聚会	北京
慕斯蛋糕，一对一教学	DIY手作	北京
夏日Mojito！业余调酒师养成记	派对聚会	北京
单向空间「喜新恋旧」市集	展览	北京
跟着一级工艺美术大师学手工剪纸	派对聚会	北京
七夕节・风花雪月的油画浪漫	派对聚会	北京
谍影重重之任务撕名牌+真人水弹CS，玩到爽！	派对聚会	北京
"咖啡品鉴,因为有味儿，所以才咂么！让舌头来此愉悦的SPA！"	DIY手作	北京
碧海蓝天，做条漂亮的裙子去踏浪！	派对聚会	北京
挑战全国最长的「悬空玻璃栈道」 ・ 平谷天云山	运动健身	北京
女神季| 私人形象顾问打造新女神，1小时教会你化妆、服装搭配	派对聚会	北京
想要法式浪漫？就住这里吧	派对聚会	北京
北方张家界天云山・ 挑战全国最长玻璃栈道	派对聚会	北京
DIY一条铅笔裙，帮你轻松搞定各种气场！	派对聚会	北京
玩转山西平遥古城・民间故宫乔家大院・品地道小吃・感受魅力晋中	户外活动	北京
「懒人生活指南」58元明星同款火锅宅家吃	DIY手作	北京
和好基友一起来做手工皂	派对聚会	北京
这个假期，亲手做条美裙出游去	派对聚会	北京
穹顶之下，我们不出门「免费」吃火锅	DIY手作	北京
「北京懒人专属」找个大厨上门烹调美食	DIY手作	北京
仅售158元，世界名曲轻松上手，成就你的钢琴梦想	文艺生活	常州
【大美潮州】潮州古城行摄广济古桥，南澳岛邂逅青澳湾	户外活动	潮州
<零基础绘画油画体验，从『手残党 』晋升『 灵魂画者』。	文艺生活	成都
零基础素描绘画没有基础一样阔以画得一副好画作	DIY手作	成都
【白岩寺银杏】（11.20）城中银杏初泛黄，山间已是满地	户外活动	成都
【金川彩林+大米亚罗2.5日】世外梨园百里红，大渡河谷万	户外活动	成都
咖啡教室-- 跟我一起做咖啡	文艺生活	成都
做一束干花手束  来自永恒的回忆	DIY手作	成都
太子岭滑雪两日游 | 中国南方雪道最长的滑雪道	户外活动	成都
和你，和泥，度过最美时光	DIY手作	成都
DIY沙瓶画 把艺术装进瓶子	DIY手作	成都
【立冬饺子派对】立冬不端饺子碗，冻掉耳朵没人管	派对聚会	成都
【专属特价】高尔夫体验 | 顶级球场，环境清幽，教练免费教学！限量哦！	运动健身	成都
OMT本心瞬悦冥想公开课 | 正视冥想，正视我们身体和心灵得到的好处	沙龙学堂	成都
【光棍节】和陌生人接吻	派对聚会	成都
高级甲油胶美甲| 你的手指那么美，指甲也要美美哒	派对聚会	成都
【绘声绘色】从素描到彩铅绘画――零基础绘画	文艺生活	成都
来源于景德镇的陶艺体验 | 拉坯+修坯+彩绘+上釉+烧制	DIY手作	成都
万圣节活动系列 | 亲手制作属于你独一无二的南瓜灯……	DIY手作	成都
【城市旅拍】拍出不一样的成都 和摄影师一起玩美生活	文艺生活	成都
【最美秋色】10.29秋风微凉，徒行醉人彩林――鸡冠山	户外活动	成都
釉下彩绘体验/笔尖上流淌千年的慢时光	DIY手作	成都
【达瓦更扎】（11.5-6）秋池渐涨 达瓦根扎 陪着我的	户外活动	成都
万圣前夜恐怖电影party | 恐怖主题派对，刺激你的心脏和眼球！	派对聚会	成都
【树舍出品】罗老师毛笔书法班	沙龙学堂	成都
陶艺体验 | 拉坯+打磨+彩绘/彩釉+烧制	DIY手作	成都
零基础绘画‖YIMO・礼物说	文艺生活	成都
【树舍出品】OMT本心瞬悦冥想 公开课与宇宙能量脉轮清理	沙龙学堂	成都
YIMO‖生态微景观DIY	DIY手作	成都
【树舍出品】性格探索游戏工作坊	沙龙学堂	成都
万圣节主题电音派对 | 邀请所有敢颠覆爱刺激的时髦鬼一起入园鬼混”	派对聚会	成都
自定义幸福――罗昂 理智与情感 沙龙⑥	文艺生活	成都
【VR虚拟现实】未来，已来，2016年的新科技，你玩儿过了吗？	文艺生活	成都
云瑶情感实战课：撩汉（妹）误区	沙龙学堂	成都
绘玩-绘出专属帆布包	DIY手作	成都
约拍 | 如果我爱上你的笑容， 要怎么拥有， 要怎么收藏。	文艺生活	成都
【甜鹿烘焙DIY】生日蛋糕（专属定制）	DIY手作	成都
用心感受泥土的细腻(拉坯+彩绘+打磨+上釉+烧制)	DIY手作	成都
青花釉下彩陶艺彩绘体验	DIY手作	成都
【国庆丨额济纳旗】（9.30-10.7）额济纳旗醉美胡杨林 魔鬼怪树林 镇北堡影视城	户外活动	成都
【国庆｜哪也不去】就在o茗●习茶	茶会雅集	成都
皮铃铛制作体验，来者有礼相送！	DIY手作	成都
力剧场咖啡戏剧现场之午后读剧会”	文艺生活	成都
【甜鹿烘焙手工DIY】蛋黄酥?酥皮月饼 | 用手掌的温度将心意融入甜点	DIY手作	成都
【中秋丨亚西拉姆草原】（9.15-16）在亚西拉姆草原以梦为马，浪迹天涯	户外活动	成都
【明月寄相思】看大片+赏月饼+走心交流 中秋特别活动	派对聚会	成都
【中秋丨川西】（9.15-17）行摄川西自驾之旅	户外活动	成都
改变-从眉毛开始	文艺生活	成都
【甜鹿烘焙DIY】蛋黄酥?酥皮月饼 | 用手掌的温度将心意融入甜点	DIY手作	成都
【手工烘焙DIY】巧克力爆浆熔岩蛋糕	DIY手作	成都
摄影.爱好者分享交流会【零基础兴趣班】| 光圈，快门，感光三者之间的关系	文艺生活	成都
9.10周六 感受初秋的凉意，穿越千年遗迹，约一场中强度徒行 鹤鸣山徒步穿越雾中山	户外活动	成都
品酒达人带你玩转葡萄酒鉴别技巧和商务礼仪	沙龙学堂	成都
听心坊・cana瑜伽体验课――仅需十元	运动健身	成都
好声音特训营吉克皓带你找自己”	文艺生活	成都
【两日飞行员】壮志凌云，驾驶直升机飞跃大峡谷和森林	户外活动	成都
厘途看电影吧/咖啡馆私享电影放映会 ~陪你看电影~	文艺生活	成都
【中秋丨泸沽湖】（9.14-17）青春醉倒在泸沽湖湿润的窗台	户外活动	成都
【甜鹿烘培DIY】玛格丽特饼干（爱人的印记）	DIY手作	成都
葡萄酒初级体验课	文艺生活	成都
伊丽莎白王后的御用花艺师带你一起玩花~	沙龙学堂	成都
【树舍出品】周二晚上小杂院！颜体学习精品小班	沙龙学堂	成都
如果你愿意一层一层地凿开木头的心，你会发现……	DIY手作	成都
【石板河】（8.28）一条行走在石头上的河流	户外活动	成都
【亚西拉姆草原】（8.27-28）在亚西拉姆草原以梦为马，浪迹天涯	户外活动	成都
【中秋丨醉美北疆】（9.9-17）最美的季节 去醉美的地方 站在醉美北疆 行摄新疆	户外活动	成都
【树舍出品】脱单秘籍 单身专题活动③ 【脱单方法论】	沙龙学堂	成都
《Single Night》 单身聚会Party | 第一句问候：很高兴认识你！	派对聚会	成都
蓉城首届丧尸生存挑战 ，火热来袭！！！	户外活动	成都
旅游英语角~~英语为你开启新人生，走遍世界的每一个角落	派对聚会	成都
现金流游戏 |  第十期 财商思维大碰撞！	沙龙学堂	成都
波普浮雕【辛普森一家】	DIY手作	成都
手工体验土与火的艺术，感受双手的创作形态	DIY手作	成都
清凉痛快两不误：撕名牌之水枪大战	户外活动	成都
【咖啡馆一日店长】研磨时光，冲泡一日暖阳给心中的秘密花园	文艺生活	成都
【听心坊・塔罗占卜】恋情卜先知	派对聚会	成都
【中秋丨色达】（9.14-17） 手持腐烂的信仰 追回逝去的梦想丨请将我揉进这团绛红	户外活动	成都
【11.11特惠】与明星蜡像合影【环球明星蜡像馆】超值特惠票19.9元，立即抢购！	派对聚会	成都
粟's | 不当月光族！小资男女理财术	文艺生活	成都
油画初体验 |亲密恋人绘	文艺生活	成都
插花DIY体验课 | 美在手中	DIY手作	成都
我不是只想教你做条裙子，你也可以成为设计师	DIY手作	成都
【夜空中最亮的星】夜跑召集令	运动健身	成都
《寻龙诀》里那朵颜值高的彼岸花	DIY手作	成都
把插画绘在松木上	DIY手作	成都
死穿白――一生只能玩一次的真人侦探推理游戏	派对聚会	成都
你的咖啡体验课	文艺生活	成都
月黑风高 杀人夜！ 咖啡馆私享桌游会 ~	派对聚会	成都
【九顶山徒步丨第5期】（7.30-31）我路过太多太美的奇景，如同伊甸般的仙境	户外活动	成都
斯玛特儿童零基础绘画体验课 | 培养孩子的绘画兴趣，挖掘孩子的艺术天赋	DIY手作	成都
【听心坊・塔罗占卜】前途占占看	文艺生活	成都
本周郑语脱口秀，来到周五！来~~~笑笑笑，爆笑全场吧！	文艺生活	成都
周日 上午10点 水墨年华 零基础国画班	DIY手作	成都
海娜纹身	文艺生活	成都
【自驾滑翔伞】（9.10）带你装逼带你飞，微户外最有逼格的活动	户外活动	成都
吉他弹唱零基础入门体验课 | 用最简单、最便捷的方式学会吉他	文艺生活	成都
夏日福利来啦：乐活山泉，7月23日龙泉摘水蜜桃大型活动！10斤内免费带走	户外活动	成都
云瑶君的情感沙龙	沙龙学堂	成都
你想听的歌，我来唱 | 以音乐为起点认识有意思的朋友	文艺生活	成都
像喝咖啡一样喝咖啡/ 来厘途玩杯测 ~	文艺生活	成都
【周末-o茗雅集】| 把柔软巴适的时光泡在茶里	茶会雅集	成都
7月16 ，决战永安湖，吃喝玩乐大咖聚会，嗨翻夜空，两日烧烤露营趴	派对聚会	成都
【手工烘焙DIY】萌到不行的京都烧果子	DIY手作	成都
【九顶山2日游】云端赏花徒步露营	户外活动	成都
换出你的好习惯-让你的个人效能提升3倍工作坊第16期	沙龙学堂	成都
炎炎夏日也能愉快的吃甜品―烘培DIY清爽的柠檬裸蛋糕	DIY手作	成都
拒绝单调，找到适合自己的色彩定位！	文艺生活	成都
来自秘密花园的召唤，与彩铅相伴的下午茶	派对聚会	成都
Cosplay of Counter Strike------真人CS	户外活动	成都
【线上微活动】以美呼唤自由，理想与情怀的梦幻邂逅	文艺生活	成都
一墨画舍约绘下午茶	文艺生活	成都
在专业录音棚里录制一首歌，作为礼物送给TA	文艺生活	成都
王老师光影教学之古风遗韵新荷赏拍	沙龙学堂	成都
仲夏夜之约 | 我在咖啡馆等你，爱情终将到来。	派对聚会	成都
【药师岩丨一日游】（7.3）虎刨泉穿越药师岩，探古寻幽-吸氧洗肺-钓鱼耍水	户外活动	成都
【线上微活动】走进大师的水墨世界，一节课告别书法小白”	沙龙学堂	成都
【线上微活动】性， 吴亦凡， 夜生活，韩国娱乐圈，让世界知道你的偏见	派对聚会	成都
九顶山徒步露营两日游  赏高山花海、观星河云海、结八方朋友	户外活动	成都
足部护理SPA |　穿着高跟鞋逛街一天累了吧，快来做个护理舒缓一下吧～	派对聚会	成都
水彩的奇思妙想 / 厘途小馆零基础绘画私享课 ~	文艺生活	成都
【红峡谷丨漂流】（6.26）峡谷柔情红峡谷川西第一漂流，穿心店地震遗址	户外活动	成都
【树舍出品】如何让个人效能提升3倍	沙龙学堂	成都
【线上微活动】合适自己的才是最好的，找到属于自己的穿衣风格~~	派对聚会	成都
若尔盖大草原3日游	户外活动	成都
【树舍出品】变成更美的自己-幼佳的美妆分享	沙龙学堂	成都
朝圣之旅.色达五明佛学院4日游	户外活动	成都
【滑翔伞丨自驾】（6.18）每一次飞翔都为了超越自我的挑战	户外活动	成都
世界名曲轻松上手，成就你的钢琴梦想	文艺生活	成都
十元免费喝，侍酒师全程服务，这样的葡萄酒体验，你来不来！	沙龙学堂	成都
【俄木塘、月亮湾2日游】红原大草原、月亮湾、龙日坝、俄木塘	户外活动	成都
软件园寻找狼人小伙伴	派对聚会	成都
轻木工体验 第二期 杓（Shao）	DIY手作	成都
逼格・葡萄酒品鉴| 请保持正确的姿势起飞	派对聚会	成都
约会攻略之去哪儿” 丨约会技巧分享课程	沙龙学堂	成都
在沙盘游戏中探索孩子的成长	沙龙学堂	成都
【树舍出品】滚蛋吧，设计师・家装自习室	沙龙学堂	成都
爵士舞0基础班	运动健身	成都
【听心坊?烘焙课】之提拉米苏	DIY手作	成都
听说，彩铅是治愈系的。	文艺生活	成都
玩聚.叠溪.松坪沟2日游	户外活动	成都
【凤栖山九龙沟】6月26日 徒步凤栖山九龙沟漂流	户外活动	成都
日本剑道体验课 | 学习安全而真实的格斗技巧，提高自身的防卫能力	运动健身	成都
终有一天 我也能成为自己情绪的主人	沙龙学堂	成都
【懒人定制】大批粽子军队来袭，快快接招！！	DIY手作	成都
匠心之陶艺体验 | 用时光摩挲泥土的随性，享受浪漫情怀	DIY手作	成都
大厨教你做日料	DIY手作	成都
肉”植觉	派对聚会	成都
【西岭前山】6月25日 徒步西岭雪山前山+花水湾冰火漂流	户外活动	成都
失控的儿童节：一场大龄儿童的狂欢	户外活动	成都
【塔罗占卜】以牌读心的预测体验	沙龙学堂	成都
【懒人・好物】「草木染手织布」手工钱包+笔记本组合装	DIY手作	成都
【听心坊・插花课】之手插扇形花束	DIY手作	成都
六一相聚 |第八届大龄儿童节-小院里的晚会	派对聚会	成都
打卤面与红酒的土鳖搭配（东北妞）	文艺生活	成都
【端午节】 自驾若尔盖4日游	户外活动	成都
休闲花艺课-小小桌花	DIY手作	成都
波普浮雕，这一次soul艺z需要你的灵魂动起来	文艺生活	成都
【懒人特供50份】 美好茶生活推荐・雨鲜六月草	茶会雅集	成都
皮肤的秘密-陶子的护肤沙龙	户外活动	成都
快乐秘方 | 5月绘画课程 外籍画师灵魂油画派对（下）	文艺生活	成都
沽酒令之一周一酒【006期-博若莱专场】	派对聚会	成都
趣味日语念习班-开心的日语新体验	讲座沙龙	成都
徒步云海之巅 最大云海雪山摄影平台牛背山	户外活动	成都
这里有风来过-原创音乐分享会	文艺生活	成都
指尖流淌的风景 | 【驿站手工课】刻纸装饰画制作	DIY手作	成都
剑尖上的优雅	运动健身	成都
空中飞盘 体验之旅	运动健身	成都
拯救月光族-工薪青年投资理财交流沙龙	沙龙学堂	成都
一起玩表演|曦剧场 在这里出演本色的自己	文艺生活	成都
零基础自由插花体验 | 让花的浪漫走进你的生活里	DIY手作	成都
孟屯河谷露营・两日游单身之旅	户外活动	成都
英文经典文学朗读	文艺生活	成都
坝坝坝电影	文艺生活	成都
【撕名牌大战】 无间道专场	户外活动	成都
遇见你的多肉小盆友 | 快来领养你的萌宠小多肉吧	DIY手作	成都
梵高 爱上POP浮雕	DIY手作	成都
古碉楼高山草甸原始森林体验式露营 孟屯河谷2日，约么?	户外活动	成都
我不是教你诈-谈判训练营	讲座沙龙	成都
【五一】探寻悬崖秘境，走进云端彝寨的质朴3日游	户外活动	成都
九顶山花海徒步露营2日游	户外活动	成都
【树舍出品】女神养成游戏之橘子形象设计课	讲座沙龙	成都
【树舍出品】配音世界―――用声音体验别样的人生	讲座沙龙	成都
【水磨格桑花】6月18日 格桑花一日游	户外活动	成都
爱之初体验   陌生人接吻	派对聚会	成都
唐伯虎点秋香主题交友聚会	派对聚会	成都
告别土气僵硬~拍出跟baby-教主一样高颜值的结婚证件照~	文艺生活	成都
『壹蜂窝』自拍和约炮都不是孤独的解药	派对聚会	成都
修道的岁月：道家五术―山、医、命、相、卜	沙龙学堂	成都
【FUNLAND茶歇】让我教你学画	文艺生活	成都
带上你爱的图片，画幅油画带回家	文艺生活	成都
【水映兰庭 ・ 茶艺共修班】开始招募……	茶会雅集	成都
【都江堰龙池】5月22日  龙池赏花正当时 徒步赏高山杜鹃	户外活动	成都
和我在法式小镇来一场浪漫的约会吧	户外活动	成都
【树舍出品 | 罗浮 | 黑色情人节】4.14 单身人士的爱情	派对聚会	成都
【葡萄周末】周末喝一杯 | 40分钟喝懂葡萄酒	文艺生活	成都
彩虹跑 ―青春，就要跑出色”	运动健身	成都
夺命之路：生存争夺战	派对聚会	成都
最美不过工笔画	文艺生活	成都
【周末小聚】我们去开房吧！	派对聚会	成都
【树舍出品】你们滴麻将没有我们滴桌游有趣桌游吧	派对聚会	成都
【树舍出品】 九型人格公开课	讲座沙龙	成都
《疯狂动物城》主题撕名牌大战	运动健身	成都
教你打造韩式水嫩裸妆	派对聚会	成都
【塔罗问事占卜】恋情卜先知	户外活动	成都
倦了茶舍少儿茶艺开课啦！	茶会雅集	成都
【树舍出品】醉猫 陪你看电影	文艺生活	成都
【树舍出品】一期一会日语课堂（初级）	派对聚会	成都
【课程预约】最接地气的茶道实修	茶会雅集	成都
让心灵在沙游中绽放	文艺生活	成都
【树舍头条】 丙申年 ・ 花朝节 ・ 百花庙会	派对聚会	成都
【树舍出品】Tim's英语角	派对聚会	成都
[茶样子出品]台湾花艺大师林雪玉的春日花房	讲座沙龙	成都
【树舍出品】Allen夫妇的英语角	沙龙学堂	成都
【树舍出品】了凡的分享	派对聚会	成都
钢琴学习 | 猫在钢琴上留下梦的脚印	户外活动	成都
【二货解忧铺】乖，快把你的二货交粗来！	派对聚会	成都
秘影私享电影沙龙：三倍生命，十万嬉皮	文艺生活	成都
春暖花开 我们还要一杯香气四溢的咖啡呀	体验课	成都
二十四节气茶会｜春分 ? 醒茶	讲座沙龙	成都
【FUNLAND茶歇】让我教你练书法	文艺生活	成都
木首饰制作--跟随木的心性去创造美好	DIY手作	成都
精致生活从品质食具开始	DIY手作	成都
【树舍*幸福的小杂院儿】周六 跳蚤市场	派对聚会	成都
浪客剑心，体味剑道之义	体验课	成都
【踏春|探线】一同探线天马镇-铁轨边的油菜花	户外活动	成都
茶样子手作鲜茶，送你一杯春天！	体验课	成都
波普浮雕，和Soul艺Z一起zuo”	文艺生活	成都
零基础冲击插画和丙烯画，不要小清新，跟soul艺一起玩点不一样的	DIY手作	成都
【春游|赏花】寻找梦中江南水乡，走进青岗菜花坞-古装摄影+轻徒1日游	户外活动	成都
【塔罗问事占卜】前途占占看	沙龙学堂	成都
千人枕头大战火爆来袭（双人套票）	运动健身	成都
有了soul艺z”，妈妈再也不用担心我的美术	文艺生活	成都
Jessie's Garden | 手作花艺体验	DIY手作	成都
开启精英小骑手养成计划!	户外活动	成都
【免费活动】3.12 周六，桃花故里探桃花，意醉情迷桃花艳，龙泉桃花沟反穿一日游	户外活动	成都
慵懒带你玩转杀人游戏 ・ 你是终极杀手么？	派对聚会	成都
绿色消费让世界多点绿	市集	成都
|第二期|  「美物」绘出你独一无二的手镯~	DIY	成都
真人角色扮演系列|谋杀系列之致命巧克力	派对聚会	成都
欢乐愚人节，燃爆青春・彩绘荧光夜跑	户外活动	成都
【Ain英语小屋】把英语玩起来	派对聚会	成都
【唯爱疯狂】雨屋”来一场不被淋湿的大雨	派对聚会	成都
【轰趴就要不一样】玩出真正的Party味道	派对聚会	成都
僵尸跑第8期―王者归来，2016强势登陆	运动健身	成都
念转福至，心想事成”――《金刚经》的生活智慧	沙龙学堂	成都
幸福就在拐角处――慵懒客栈单身汪见面会	派对聚会	成都
【树舍出品】琉璃光的加持――《药师经》分享讲座	讲座沙龙	成都
生活太无聊？一起学表演，释放压力，找寻自我!	戏剧	成都
【1元活动】3.6周日，开年探梅栀杆村，赏千亩梅林盛景，醉心香梅酒中。	户外活动	成都
春游|赏花   开往春天的小火车-嘉阳小火车轻徒1日游	户外活动	成都
得一琴馆古琴、古筝长期招生	体验课	成都
葡萄美酒夜光杯  | 打开品鉴葡萄酒的正确姿势	文艺生活	成都
好玩儿的实用摄影课	讲座沙龙	成都
赶年集办年货，年味儿从这里开始！	市集	成都
【玩乐成都】年度玩家终极派对	派对聚会	成都
大假前夕，你准备了哪些招式来应对三姑六婆们？？	派对聚会	成都
国乐体验 | 穿越古今，做个筝韵女子	文艺生活	成都
?节课至少学会?首你喜欢的民谣	文艺生活	成都
唱歌不再跑调-流行演唱体验	文艺生活	成都
来森小花种上一份满满的心意送给ta吧	体验课	成都
骆谊恒电影心理学课堂：《卧虎藏龙》	电影	成都
三角人格分享沙龙 教你慧眼识人	讲座沙龙	成都
慵懒腊八节・暖心腊八粥	派对聚会	成都
实星球咖啡教室―咖啡新技能get!	体验课	成都
慵懒英语角? speak out	派对聚会	成都
通感皮影?共享童年	派对聚会	成都
【毕棚沟2日游】双板滑雪 雪地温泉 浓郁藏羌名族风	运动健身	成都
慵懒气质?绘出你的精彩	DIY	成都
慵懒图书交换阅读・思想的邂逅	派对聚会	成都
三角人格分享沙龙―慧眼识人	讲座沙龙	成都
球神大战趣味运动	运动健身	成都
正确认识易经 学会自占自解	派对聚会	成都
成人钢琴速成课体验	文艺生活	成都
爆裂架子鼓疯狂体验 | 忘却心里的烦恼，用音乐来净化心灵。	文艺生活	成都
我不是教你诈-谈判专家训练营	沙龙学堂	成都
橘子的个人形象设计系列课	派对聚会	成都
周六占星沙龙系列	讲座沙龙	成都
尤克里里超值教学体验 | 轻松地表达你内心的想法	文艺生活	成都
【疯狂抢礼物】圣诞狂欢变装趴	派对聚会	成都
Enjoy steak	DIY手作	成都
汉舞工坊丨小脸谱涂鸦	市集	成都
自己动手做萌哒哒节日伴手礼	DIY	成都
体验奇妙沙游世界	体验课	成都
认识生命数字―了解幸福密码	派对聚会	成都
「成都周边一日游」：都江堰赵公山	户外活动	成都
树舍头条 |  感恩时光美食交友感恩节派对&树舍新店开业庆典	派对聚会	成都
动手做一个多肉拼盘	派对聚会	成都
【别墅轰趴】一次玩残”你	派对聚会	成都
静心茶道初级班	讲座沙龙	成都
［薇花园Whisper］有肉”的下午茶	DIY手作	成都
零基础轻松学钢琴！390元包月随便上课练习	文艺生活	成都
解锁咖啡新世界―私藏咖啡”体验课	体验课	成都
「成都周边一日游」：彭州天台山	户外活动	成都
「禅舞体验课」禅珈合一・瑜伽垫上的韵舞禅动	运动健身	成都
烘焙DIY饼干 | 用心来制作一份属于自己的萌饼干	DIY手作	成都
惬意时光 ・ 娇花花插花之乐	派对聚会	成都
光棍也疯狂：豪华公寓睡衣派对	派对聚会	成都
老丁和他的朋友们沙龙：我想要的生活？	派对聚会	成都
模拟CEO视角：商业策划和运营管理	派对聚会	成都
色釉瓷绘――画出最美故事	派对聚会	成都
「烘焙体验课」手把手教你学烘焙，然后带着劳动成果回家	DIY手作	成都
【白岩寺银杏】金秋最美银杏林	户外活动	成都
来一场最温柔的暴力	派对聚会	成都
美籍华人Tim的英语角	派对聚会	成都
巷弄里●绘生活――莲遇布	体验课	成都
心有千千结―― 中国结编织艺术	派对聚会	成都
万圣节奇妙搭讪夜	派对聚会	成都
拼演技！――零基础话剧体验活动	文艺生活	成都
【僵尸夜跑】万圣专场――哈罗喂！来自魔鬼的邀请！	运动健身	成都
【独家试爱】我与流氓”有个约会	派对聚会	成都
2016.1.15 邂逅牛背最美360°观景平台	运动健身	成都
金秋逍遥野炊――山野纯体验一日	户外活动	成都
玩聚课程 | 只要两小时，你就能学会摄影！！！	讲座沙龙	成都
一起玩雪去吧 徒步成都第一峰西岭雪山	户外活动	成都
灵异故事会：诡来了	派对聚会	成都
只要两小时，你就能学会摄影！！！	体验课	成都
做回古典美人，汉式盘发技法初级班	派对聚会	成都
I??U 情侣多肉盆景DIY	派对聚会	成都
川西秘境--玛嘉沟2日游	户外活动	成都
情迷色达4日精品小环线	户外活动	成都
【国庆】色达/新都桥/年宝玉则 5日游	运动健身	成都
中秋特辑：撕名牌之大闹天宫	运动健身	成都
不一样的手绘|实星球手绘之夜―手绘木片	派对聚会	成都
相约泸沽湖，邂逅神秘女儿国！	运动健身	成都
烘培DIY玫瑰杯子蛋糕	DIY手作	成都
体验创作的乐趣，手绘河滩石	体验课	成都
只要两小时，你就能学会摄影！	派对聚会	成都
"体验油画,体会一种生活"	文艺生活	成都
线下户外真人游戏：「盗梦空间」碟中谍！	运动健身	成都
人人都需要了解的面相小知识	派对聚会	成都
零基础疯狂学：一起来学魔术吧！	派对聚会	成都
道格拉斯的烘焙教室第3期－蓝莓蛋糕	派对聚会	成都
佛法中的智慧，「金刚经」经文研习	派对聚会	成都
城市街头生存挑战，一生难得疯狂一回，你敢来吗？	派对聚会	成都
琉璃光的加持――《药师经》分享讲座	派对聚会	成都
拯救月光族――投资理财交流沙龙	派对聚会	成都
【分享会】 这个老外跑了17年，每天15公里，你呢？	运动健身	成都
Max心灵空间5 ：在感情里我的需要”是什么？	派对聚会	成都
［薇花园Whisper］下午茶：种肉、看书、闲聊或者只是简单的放空自己	下午茶	成都
干掉压力！High啪”&千人枕头大战，震撼来袭！	派对聚会	成都
【限时特惠】陶艺拉坯 曼妙时光体验	DIY手作	成都
「古琴体验课」零基础起步学古琴以及琴歌弹唱，请允许自己体验一次琴感”！	文艺生活	成都
与多肉邂逅的下午茶	体验课	成都
山人乐队山姗来迟” 巡演	暂不开放	成都
果味VC 2015双重攻势全国巡演 成都MINI	暂不开放	成都
僵尸跑第6期―【世纪大战】，加入神秘星”角色！	运动健身	成都
亲手做一款烘焙和咖啡带回家吧！	DIY手作	成都
云谣君游戏：真人RPG侦探游戏叹息山庄杀人事件	派对聚会	成都
【树舍出品】当生活遇到奇迹，心灵魔术秀「知晓」	派对聚会	成都
沁听松林之八疯下午茶――这次咱随便聊聊啥？	派对聚会	成都
1日游 | 大邑烟霞湖，置身于世外桃源	运动健身	成都
管理你的情绪，只须「一念之转」	派对聚会	成都
1日游 | 彭州白鹿镇，漫步白鹿中法风情小镇	运动健身	成都
【高尔夫】 多一种生活方式	运动健身	成都
「冰点特惠」道格拉斯的烘焙教室第二期――纸杯蛋糕	DIY手作	成都
女王驾到――夏日妆容更要气场全开	派对聚会	成都
借我一个吻，I will kiss you back，还有单身汪惊喜派对~~	派对聚会	成都
破解你的生命密码――明道皮纹沙龙	派对聚会	成都
一粒沙知我心 | 30元沙箱游戏 ? 特别活动！	派对聚会	成都
专业老师手把手教你做一款咖啡和烘焙~	DIY手作	成都
「七夕特辑」蓝胖子、HelloKitty翻糖饼干，亲手做来送给Ta~	DIY手作	成都
1日游 | 都江堰龙池徒步休闲避暑（成不了行勿拍）	运动健身	成都
僵尸夜跑第5期【末日来临】来袭！！！预售开始！	运动健身	成都
每周五Lady's night，姐妹淘们畅所欲言~	派对聚会	成都
「浮游趴」当我途径你的绽放，会擦出怎样的火花与激情？	派对聚会	成都
百鬼夜行・莫回头	派对聚会	成都
「烘焙沙龙」每周手把手教你做烘焙	DIY手作	成都
真人RPG推理游戏系列三――生死局	派对聚会	成都
「成都周边一日游」：彭州葛仙山	运动健身	成都
这是一次有预谋的体验式单身趴：「缘来，你也在这里」	派对聚会	成都
「美的历程」由声到颜，带你领略诗歌之美	派对聚会	成都
「零基础学钢琴」钢琴入门体验课，激扬钢琴梦~	文艺生活	成都
舌尖上的新疆菜，还有这种玩法？	DIY手作	成都
热死宝宝了！～这个周末要不要来点凉快的？来手绘一把团扇吧~	派对聚会	成都
配音世界：用声音演绎不同的人生	派对聚会	成都
MAGIC MAKE UP魔法彩妆课	派对聚会	成都
创意「石头」绘，绽放在掌心的奇妙世界	派对聚会	成都
这个夏天一起来玩色彩吧：手绘水彩明信片体验！	派对聚会	成都
「空持百千偈，不如吃茶去」别墅里的茶道体验课	派对聚会	成都
指尖的魔法，「手绘套中人」	派对聚会	成都
JJC格莱美颁奖晚会	派对聚会	成都
魔房烘培课亲子专场－第6期：熊猫饼干	DIY手作	成都
从咖啡渣窥探你的生活――神秘土耳其咖啡占卜之旅	派对聚会	成都
"春熙路现场\""扫街―带你玩转【街头摄影】（内有福利敢不敢不点！）"	派对聚会	成都
「美物」绘出你独一无二的手镯~	派对聚会	成都
「遗忘式”英语学习体验课」不记笔记，没有作业的英语课	派对聚会	成都
徒步红峡谷悬空木栈道	运动健身	成都
1日游 | 观溶洞，圣灵山地质公园	运动健身	成都
体会书法的纯粹美，罗老师的书法班	派对聚会	成都
「每周技能」把「永生花+多肉+海娜纹身+羊毛毡」统统带走~	派对聚会	成都
把森林”捧回家，苔藓微景DIY	DIY手作	成都
红原/若尔盖 草原精华之旅	派对聚会	成都
论一个创客的自我修养 | 组装一个3D 打印机吧(第三期)	派对聚会	成都
雨过天晴 | 遇见最美的彩虹，彩虹慕斯蛋糕出自你手~	DIY手作	成都
真人探案游戏：「沃特顿庄园」，真相永远只有一个！	派对聚会	成都
幼佳的美妆课--变成更美的自己	派对聚会	成都
优雅的三小时：我与梵高有个约会「麦田里的丝柏树」	派对聚会	成都
创客「深圳Maker Faire」亲历分享，干货一大把！	派对聚会	成都
专业，是一种态度――专业老师教你做「泡芙+虹吸式咖啡」	DIY手作	成都
惊恐之夜 ・ 成都首款「僵尸夜跑」之一线生机！	运动健身	成都
福尔摩斯推理之旅--本周沃顿庄园杀人案（满8人开局）	派对聚会	成都
完美小姐进化论，形象设计初阶课	派对聚会	成都
「古琴体验课」零基础起步学古琴以及琴歌弹唱，来感受一次吧！	暂不开放	成都
相约星期二，穿行心理茶会-- 自我实现心理学	派对聚会	成都
如何成为高情商的人，萨提亚家庭模式沙龙	派对聚会	成都
认识自己，与自己的性格对话 ―― DISC之「谈判技巧」	派对聚会	成都
如何让你的粉丝数突破2万？ 从零开始学「微营销」实操（6月10日首次课）	派对聚会	成都
OH Cards潜意识直觉卡心理游戏，看透你的心哦~	派对聚会	成都
拥有自己的「单曲」，专业录音棚为你量身打造	文艺生活	成都
露营俄木塘|最美草原花海	派对聚会	成都
「穿越回童年」U-TREE 第一届大龄儿童节，操场见！	派对聚会	成都
淼淼的主题英语角 | 听她的游学经历以及英语学习大法	派对聚会	成都
牛背山2日游 | 最大云海雪山摄影平台、全越野零徒步	运动健身	成都
街相妙景 ・ 法国摄影帅哥的分享沙龙（全场英文请自带技能）	派对聚会	成都
「我想开间咖啡馆」实星球咖啡体验教室（会员价~）	DIY手作	成都
什么时候学都不算晚 ・ 家庭理财沙龙	派对聚会	成都
你与毕加索，只有一支笔的距离：「彩绘小石头+雪糕棒书签+布艺小鱼」一次性打包给你！	派对聚会	成都
这就是生活 ・ 心理驿站	讲座沙龙	成都
催眠潜意识体验会 ・ 读心术	派对聚会	成都
和歪果仁聊聊天 ・ Allen夫妇英语角	派对聚会	成都
素の半边塔罗独白，从此占卜不求人	派对聚会	成都
「实星球手绘」秋日的水彩小景	派对聚会	成都
遇见未知的自己「探索篇」	派对聚会	成都
大连帆船体验，夏日出海新玩乐	户外活动	大连
大师教你学钢琴，   快速晋级钢琴大咖	文艺生活	大连
享周末，学英语！送教材+学习方法+测试	沙龙学堂	大连
是时候亮出自己的智商了「奥秘之家真人密室逃脱」	运动健身	大连
我戳！我戳！我戳戳戳！戳羊毛毡！超减压哦～	派对聚会	大连
制一款独属自己的香｜DIY精油香水体验	派对聚会	大连
周末减减压 来做版画吧！	派对聚会	大连
橡皮章の雕刻初体验！	派对聚会	大连
宝苞农场雪梨瓜旅游文化节	户外活动	佛山
趣味DIY烘焙―快乐王国	DIY手作	佛山
每周一花的小幸福 ・ 花点时间	文艺生活	佛山
「萌猫零距离互动」主题嘉年华空降佛山	暂不开放	佛山
3.3周四 | 说话如何像讲故事般吸引人（精品课程）	讲座沙龙	佛山
2.25周四 | PPT是你职场上的脸，今天教你怎么美容。	讲座沙龙	佛山
2.20周六 | 桌游之夜（交友沙龙）	派对聚会	佛山
2.19周五 | 如何瞬间构建思路并有力表达？（职场技能）	讲座沙龙	佛山
2.18周四 | HI摄影：玩单反，最佳入门秘诀在这里！	讲座沙龙	佛山
双人射箭套餐体验 圆你一个武侠梦	运动健身	佛山
宝苞农场观光票 | 畅游七彩花田，喂养小动物，骑车兜兜风	户外活动	佛山
宝苞农场亲子一日游（2大1小）| DIY棉花糖、饲养羊驼、采摘果蔬	户外活动	佛山
单人射箭反曲弓体验	运动健身	佛山
度休闲欢乐时光 | 饲养羊驼，高尔夫练习，户外品氧套餐	户外活动	佛山
双人2日度假套餐 | 星宿露营，放河灯，高尔夫练习	户外活动	佛山
【服装设计DIY】你和女神只差一条美裙	DIY手作	佛山
美式风格短夹	DIY手作	福州
简约拉链手包	DIY手作	福州
皮雕杯垫定制DIY	DIY手作	福州
一起来DIY个马赛克瓶吧	派对聚会	福州
「静觅厨房」甜点系列之奶油蛋糕	DIY手作	福州
「爱的研习社」有个恋爱和你谈一下 ・ 提高相亲成功率	派对聚会	福州
一起拼豆子吧	派对聚会	福州
陶艺DIY体验课+上釉、烧制一件、茶饮	DIY手作	广州
美式橄榄球全装备体验活动	运动健身	广州
零基础服装设计｜想美出天际？你只差一条丝绒百褶裙	DIY手作	广州
第一届【看海节】之黑排角海岸线穿越	户外活动	广州
给自己一个理由热爱现代舞（basic/advanced）	文艺生活	广州
11.12深圳盐田海滨栈道一天休闲行摄绝色海景	户外活动	广州
【金媒人--相亲旅游】11月20号周日~相约珠海野狸岛	派对聚会	广州
【体育中心】零基础爵士舞  M.E的正确打开方式	运动健身	广州
休闲羽毛球 | 一起运动吧~~温暖整个冬天	运动健身	广州
量声定做”适合你的声乐初级班 | 你的声音从来就很悦耳	DIY手作	广州
带你装逼带你飞 空中瑜伽＆悬吊普拉提体验	运动健身	广州
【DIY半身裙】只需2小时，赫本女神裙，轻松自己做！	DIY手作	广州
11月13日 穿越英西小桂林 欣赏广东最长峰林	户外活动	广州
【那琴湾奇石林】那琴湾海岸线穿越，赏奇石观沧海	户外活动	广州
广州国际艺术博览会 | 赴一场世界各地艺术盛宴	文艺生活	广州
【双十一抢票】声乐―流行音乐发声训练体验课，40分钟教你	文艺生活	广州
【体育中心】零基础学爵士舞高品质8课时小班体验课	运动健身	广州
【广西黄姚，特价活动】穿越时空我的梦境之旅，流淌千年黄姚	户外活动	广州
《釜山行》┃艺术馆惊魂夜万圣狂欢趴，你敢来吗？	派对聚会	广州
吉他体验课，1个小时学会弹唱	文艺生活	广州
声乐体验课 教你唱好喜欢的歌！	文艺生活	广州
【缝纫.茶艺】裁一袭旗袍 ，兼修茶艺礼仪	DIY手作	广州
11月20日｜周末带你去看海，徒步东西冲海岸线	户外活动	广州
【10.30登山节】2016第一届巅峰户外登山节盛大开幕	户外活动	广州
[木作课程-手作木匙班] 体验一把勺子的创作过程	DIY手作	广州
尚基?布梵公益形象设计沙龙 | 女人必须精致，这是女人的尊严！	沙龙学堂	广州
手作亲子装，妈妈给孩子最贴心的礼物	DIY手作	广州
【11月6日 周日】徒步英西峰林+探秘阳岩洞	户外活动	广州
让青春在场，为你定格美好时光	文艺生活	广州
一针一线，制作一个短款钱包送给TA	DIY手作	广州
实用心理学技术｜潜意识投射卡	沙龙学堂	广州
尤克里里体验课，1小时学会弹唱！	文艺生活	广州
你的第一堂【声音训练课】Hold住任何场合的好声音”都是训练出来的！！！	沙龙学堂	广州
国画体验 | 翻开花鸟学习篇章	文艺生活	广州
广东第一峰 | 登石坑崆，看日出云海	户外活动	广州
尤克里里体验课  一小时学会弹唱	文艺生活	广州
姑娘，从没用过缝纫机的你，1天就能完成一件旗袍	DIY手作	广州
情迷三门岛露营、快艇冲浪登山看日出 | 玩水、飞艇、海岛露营、日出	户外活动	广州
【ACOOK烘焙课】法式柠檬火焰挞---夏日里一抹清新的亮黄色	DIY手作	广州
【北京路】零基础学爵士舞 | 舞蹈 是一种生活方式	运动健身	广州
【公益课】零基础教你看穿一线大牌时装 做衣服没那么难！	沙龙学堂	广州
成人零基础学钢琴 40元学习2首歌曲 送琴谱 包教会	文艺生活	广州
成人绘画兴趣班 | 从大师画作感受光与色	文艺生活	广州
199元为您带来5节零基础钢琴课！	沙龙学堂	广州
零基础服装设计 | 穿上小黑裙，演绎你的法式优雅	DIY手作	广州
《当众表达》每个成功的职场人士，必修的一门课！	沙龙学堂	广州
周六骑马，我们马”上见！	户外活动	广州
【金媒人~三高”专场】12月18日周日~为你而来	派对聚会	广州
[木作课程-手作木簪班] 我要拥有一支独一无二的发簪	DIY手作	广州
攀岩初体验，毅力攀爬挑战自我，专业教练带你飞！	户外活动	广州
"筑梦?行天下(建筑,西班牙旅游主题分享会)"	沙龙学堂	广州
礼遇 | 换旧习惯，有心回馈	DIY手作	广州
醉美狮子岛海岸线穿越 抓海胆捞海带，戏小虾	户外活动	广州
【服装DIY】听说，一条美裙，会把你带到男神的身边	DIY手作	广州
早间Zumba班清新开启！ 特邀新加坡资质最全女教练！	运动健身	广州
diy冰皮――你离美食达人只差一块冰皮月饼	DIY手作	广州
徒步英西峰林，邂逅最美小桂林，梦幻般的田园风光	户外活动	广州
【每周3晚】教你成为万人迷----持续内容变化ing	沙龙学堂	广州
没有韩国欧巴，只有大厨和思密达美食，约吗	文艺生活	广州
一个小时教你学会尤克里里弹唱，实现你对文艺生活的追求	文艺生活	广州
【8.28 葡语工作坊】男神讲座之两只牙”的爱恨情仇	沙龙学堂	广州
享瘦甩脂，拒绝枯燥无趣的健身方式！	运动健身	广州
【珠宝设计学堂】之钻石设计	沙龙学堂	广州
零基础学爵士舞高品质小班教学 | 跳爵士街舞，每天保持好心情	运动健身	广州
风小孩 素食音乐盛典 | 素食、市集、演出互动，欢乐不断	派对聚会	广州
周日声乐体验课~教你唱好喜欢的歌	派对聚会	广州
尤克里里体验课~一小时学会弹唱	DIY手作	广州
唠嗑空间｜听理・立说	沙龙学堂	广州
这个周末我们去射箭吧	运动健身	广州
城阅生活读书会	文艺生活	广州
吉他体验课 | 一小时学会弹唱	文艺生活	广州
成人零基础试听课 | 学习《我和你》、《欢乐颂》	沙龙学堂	广州
周四理财学院：女子理财沙龙	派对聚会	广州
剩3个名额|告别外卖党，自己做饭才是正经事	DIY手作	广州
周日声乐体验课 教你easy唱好喜欢的歌	DIY手作	广州
吉他体验课，一小时easy学会弹唱	DIY手作	广州
尤克里里体验课，一小时easy学会弹唱	DIY手作	广州
零基础陶艺DIY：指尖触摸温柔，用心感受细腻	DIY手作	广州
带上书 ---- 配上一杯属于自己的咖啡	文艺生活	广州
红酒品鉴会 | 品味舌尖上的奢华	茶会雅集	广州
私人定制录音体验 | 你的歌手梦从未止步于方寸之间	文艺生活	广州
下班咋们来一场桌游交友活动吧	派对聚会	广州
DIY 卡通忌廉蛋糕	DIY手作	广州
【金媒人~湖南籍专场】11月27日广州大型高品质相亲交友专场	派对聚会	广州
梦享课堂｜刀拉HENNA纹身课，让你Get一门炫酷技能！	DIY手作	广州
如何打造声音名片	沙龙学堂	广州
Let us Talk on Sunday Night	派对聚会	广州
在古港像个艺术家一样画油画	文艺生活	广州
汕尾龟龄岛露营、快艇冲浪、烧烤看日出	户外活动	广州
尤克里里体验课 一小时学会弹唱	DIY手作	广州
观音山溯溪玩水 畅享清凉夏日	户外活动	广州
尤克里里体验 | 一节课就会自弹自唱清新小调	文艺生活	广州
西关小屋零基础油画班	文艺生活	广州
梦享影院 No.127 《辩护人》	文艺生活	广州
【广东籍专场】2月26日相亲交友 | 趁春光还未远去，老乡，咱们约会吧!	派对聚会	广州
第一届看海节之最美盐田海滨栈道	户外活动	广州
【私人沙滩露营】狮子岛冲浪，双月湾赏醉美日出日落	户外活动	广州
徒步影溪线，穿竹林越小溪	户外活动	广州
探秘广东大峡谷，看高空表演，瀑布绿潭戏水，清凉避暑	户外活动	广州
听理 ・ 立说No.3｜从《招魂》开始，探秘那些古老的鬼神传说	派对聚会	广州
湿身大趴！玩转清远牛仔谷探险+漂流！	户外活动	广州
【线上微活动】韩国娱乐圈， 吴亦凡， 夜生活，让世界知道你的偏见	派对聚会	广州
中国时尚教母韩托主讲《服饰搭配和盈利密码》	沙龙学堂	广州
【手作课程】亲手制作一把勺子”	DIY手作	广州
周日：来一局狼人杀，桌游交友	派对聚会	广州
【七夕】求爱，就来学个鸡尾酒呗	派对聚会	广州
【同道大叔】 潮爆星座嘉年华，满足你对星座的一切妄想	文艺生活	广州
6.28周二 | 精致妆容――做优雅女人（美妆学堂）	沙龙学堂	广州
寻找广东最大峡谷―乳源大峡谷	户外活动	广州
【线上微活动】以美呼唤自由，理想与情怀的悄然邂逅	文艺生活	广州
商务西语/商务葡语/旅游西语口语＆搭讪/ 对外汉语西语公开课	沙龙学堂	广州
【线上微活动】一节课告别书法小白，走进大师的世界	沙龙学堂	广州
深圳荷兰花卉小镇1日游	户外活动	广州
Ukulele10元体验课，一小时内自弹自唱	派对聚会	广州
高级教师1对1体验课	派对聚会	广州
踩点小组丨漆黑阶段二（意象解图）	派对聚会	广州
穿越清远南峡，领略小北江风情	户外活动	广州
【线上微活动】合适自己的才是最好的，找到属于自己的穿衣风格！	派对聚会	广州
亲手制作一款多功能钥匙包	DIY手作	广州
用高颜值图表撩遍小伙伴（excel图表制作）	沙龙学堂	广州
零基础油画下午茶 许你一段优雅时光	文艺生活	广州
周六吉他体验课|一小时学会弹唱	文艺生活	广州
尤克里里体验课，一小时学会弹唱	文艺生活	广州
登山拉链六片山环线	户外活动	广州
邂逅凤凰古城，来一场艳遇之旅	户外活动	广州
化妆小白这边看，一个下午让你上手日常上班妆！	沙龙学堂	广州
【溯溪】在溪流戏水，慢走古劳水乡，品青花大盆菜一日游	户外活动	广州
仅需158元  世界名曲轻松上手 ，成就你的钢琴梦想	文艺生活	广州
父亲节送给父母最好的礼物是告诉他们我找着对象啦”！！！	户外活动	广州
这年头，怎样都要学个简单的乐器！!	文艺生活	广州
穿越芙蓉嶂，回归自然感受生活	户外活动	广州
徒步中山九寨沟，五星营地赏水杉	户外活动	广州
电影+小伙伴= 周五晚一起懒	派对聚会	广州
邂逅奥地利童话世界，环红花湖骑行	户外活动	广州
登羊城帽峰山，品太和烧鸡一日活动	户外活动	广州
【懒人定制】大批粽子军队来袭，快快接招！！！！！	DIY手作	广州
梦回黄姚千年古镇，享受慢时光	户外活动	广州
高栏港海岸穿越，看浪漫大风车	户外活动	广州
勇登广东第一峰，看日出云海	户外活动	广州
【石牌桥】暑假游泳培训成人班开班啦！！	运动健身	广州
9.9元享瘦减脂班初体验！全程享瘦管家式提供服务以及全程教练指导训练	运动健身	广州
【闲日DIY】香葱火腿司康，传统の英式点心！	DIY手作	广州
高山流水遇知音 古琴零基础体验课	文艺生活	广州
优活招财猫音乐盒粘土DIY	DIY手作	广州
周五晚绝对约狼人杀！	派对聚会	广州
探戈赏析会	沙龙学堂	广州
射箭体验 | 会挽雕弓如满月，西北望，射天狼	运动健身	广州
周末，来与英语约一场小清新聚会	沙龙学堂	广州
全程管家式服务的健身或瑜伽小团课开始招生啦	运动健身	广州
广州成人钢琴培训299元学习20节课零基础一对一授课	文艺生活	广州
把小森林装进我的玻璃球：多肉盆栽DIY	DIY手作	广州
【相亲离异专场】1月15日美丽新世界	派对聚会	广州
行顺德最美水乡，赏岭南园林，享舌尖美食	户外活动	广州
亲手做一份多肉微景观	DIY手作	广州
踩点小组 | 漆黑的心跳体验	派对聚会	广州
骚年，你想怎么玩转世界？	沙龙学堂	广州
【广州相亲会】11月19日~每周六大型高品质相亲交友活动	派对聚会	广州
经常泡吧，还不如来学个乐器！!	派对聚会	广州
六片山环线登山拉练	户外活动	广州
原来水彩可以很简单-画美食	文艺生活	广州
零基础成人钢琴乐理课一节|时尚钢琴	文艺生活	广州
299元享受一个月钢琴学习，每天授课，无需预约！	文艺生活	广州
流行K歌实战（98元，K房实战2小时）	派对聚会	广州
给妈妈的母亲节礼物：亲手为她扎束花！	DIY手作	广州
5.07周六下午丨与艺术相遇―零基础油画临摹（第5期）	文艺生活	广州
Lazy儿，DIY一杯鸡尾酒	派对聚会	广州
五一不出游，品酒看世界	派对聚会	广州
【五一假期●烘焙DIY】 05月01日(周日)上午+下午｜低脂豆腐戚风，史上最健康的戚风	DIY手作	广州
4.30周六 | 约会怎么聊才迷人？	文艺生活	广州
5月1日：走进珠海高栏岛，邂逅广东最美风车山！	户外活动	广州
4.30周六晚丨学调一杯鸡尾酒，给他/她（鸡尾酒速学课程火热报名中）	文艺生活	广州
【龟龄岛露营】我们睡在帐篷里，在星空下，听海风与贝壳私语。	户外活动	广州
一日皮匠 | 让手艺走在路上，牛皮手帐	DIY手作	广州
【以筝结友，共享筝之乐】古筝体验课	文艺生活	广州
多彩黔东南 肇兴侗寨-堂安梯田 高铁出发	户外活动	广州
成人钢琴零基础体验课，让您一节课学会弹钢琴！	文艺生活	广州
感恩母亲，为爱健行徒步大会（广州站）召集啦	运动健身	广州
一日皮匠｜男士专属短钱夹	DIY手作	广州
周六下午| 多肉植物DIY―自制萌宠带回家（第4期）	DIY手作	广州
手掬一把沙，幻化为画	文艺生活	广州
99元高尔夫特惠之旅：赠球杆+手套+教学+100颗击球	运动健身	广州
4.26周二晚丨桌游交友―狼人杀	派对聚会	广州
邂逅南中国最美高山草原―江西武功山	户外活动	广州
做有自己味道的巧克力	DIY手作	广州
#80后爱自由系列#之《运用高财商，25W在广州买房买车》	沙龙学堂	广州
06.05周日午丨女性优雅仪态气质提升沙龙（第6期）	沙龙学堂	广州
流行音乐歌唱体验课 | 一对一个性定制，独特发声技巧让你成为K歌之王	文艺生活	广州
慢生活手工课堂 | 传统蜡染DIY	DIY手作	广州
阳朔半自助深度游 徒步漓江 骑行遇龙河	户外活动	广州
零基础学尤克里里，包您学会。	文艺生活	广州
4.16周六下午丨萌宠养成记―多肉植物DIY（第三期）	DIY	广州
招生柬 | 窈窕淑女，琴瑟友之	文艺生活	广州
夜空中的星！亲手制作萌系宠物台灯	DIY手作	广州
4.17周日丨互联网遇见新媒体，该怎么玩？	讲座沙龙	广州
百变丝巾魔法学堂	DIY手作	广州
穿越龙脊梯田-徒步漓江画廊-登顶老寨山	户外活动	广州
网红教你做一盒上天的便当（剩2个名额）	DIY手作	广州
周末一起玩【桌游趴】	派对聚会	广州
4.15周五晚丨桌游交友―狼人杀（第13期）	派对聚会	广州
【旗袍制作课】制作你的专属旗袍，展现东方女性的婉约与美丽	DIY手作	广州
南箫王---箫韵禅心养生雅集	派对聚会	广州
【遇见古镇】走进黄姚古镇，领略别样古朴宁静的梦境	户外活动	广州
游荡赤坎古镇觅百样美味，穿行开平碉楼，看历史绽放在眼前	户外活动	广州
3.31周四丨时光影展―张国荣 ・ 十三周年纪念观影	电影	广州
春耕节 体验千人宴  攀登天梯金子山看杜鹃花	户外活动	广州
如何快速有效的影响他人？	讲座沙龙	广州
4.10周日｜爬上山头去看杜鹃花海，通天蜡烛一日登山徒步	户外活动	广州
真皮皮带制作课~~	DIY手作	广州
双月湾露营 赏日出日落 狮子岛冲浪	户外活动	广州
零基础99元包学会三首入门级钢琴曲	文艺生活	广州
3.31周四丨优雅仪态沙龙	讲座沙龙	广州
3.27周日｜看海 杨梅坑踩单车 较场尾寻美食	户外活动	广州
还在嫌弃生活千篇一律太无聊？一起来表演吧	沙龙学堂	广州
Hey，Cool Girl，一起来场HIPHOP!	运动健身	广州
3.25周五丨在游戏中学会理财―现金流游戏（第二弹）	派对聚会	广州
意式杂菜芝士面包：叶绿素与奶制品的火花	沙龙学堂	广州
周末带你一起摄影一起飞。	文艺生活	广州
【我图电影院三月】法语主题电影	电影	广州
一起吃饭，聊片儿	派对聚会	广州
【有趣】 下雨的周末玩什么？一起来跟陌生人玩桌游吧	派对聚会	广州
【蕉”气蓬勃】脱口秀	小型现场livehouse	广州
醉美乡村油菜花海 徒步王子山绿道	户外活动	广州
【三月高栏岛】徒步珠海高栏港赏风车一日游	户外活动	广州
麻油叶刘明汉：斑驳树影，交错年华	暂不开放	广州
开平逛赤坎古镇、看碉楼、赏油菜花	户外活动	广州
HI课主题户外―一起玩趣味暴走、撕名牌	户外活动	广州
亲手打造指尖的温度――手工制银课程	体验课	广州
取材自然，画出自然 | 松木片绘画课	文艺生活	广州
爱TA，就为TA亲手做一件创意手工皮具	体验课	广州
ALOHA市集，遇见陌生人	派对聚会	广州
【展览推荐】媚猴王”72变！―― 黄薇个展	展览	广州
我的专属声音教练”	沙龙学堂	广州
【植树节】属于你的微景森林diy	DIY	广州
亲手调制一杯炫酷的鸡尾酒吧	派对聚会	广州
背着情人浪尽美国―背包客60天万元环美分享交流会	讲座沙龙	广州
女生节带上你的闺蜜一起画画|闺蜜同行，一人免单	DIY	广州
在东山口小洋楼里摆地摊有多美？	市集	广州
3月6日-走进开平碉楼，逛古镇品美食赏油菜花	户外活动	广州
新的一年，从学尤克里里开始！	体验课	广州
3.5周六 | 陌生人一起玩桌游（主题社交）	派对聚会	广州
广州最美路线・星溪线赏李花观竹海逛古村落	户外活动	广州
如果3月20日世界末日，你会带上哪个ta，一天的测试便可分晓	派对聚会	广州
"MEG环球魔幻世界体验票\"""	DIY	广州
走进开平碉楼，逛古镇品美食赏油菜花	户外活动	广州
成人钢琴体验课，让您一节课学会弹钢琴！！	暂不开放	广州
信封手包制作，一缝一线，匠心体验	DIY手作	广州
3.2周三 | 人生不是你想买，想买就能买。（主题活动）	定制方案	广州
告别宅时代，桌游玩乐过	派对聚会	广州
桃花会－－男女搭配一起包饺子活动	派对聚会	广州
深圳最美海岸线--红排角，邂逅海鸥、红树林、灯塔	户外活动	广州
年后刮油行动|沙拉&果蔬汁（剩6个名额）	DIY手作	广州
美妙吉他之旅|4个月不限次数随便学	文艺生活	广州
2.28穿越深圳最美海岸线-东西冲	户外活动	广州
12节课 只要650 学会尤克里里	沙龙学堂	广州
【春游看海】-捡海螺，钻石洞，穿越海螺角，最美浅海戏水	户外活动	广州
意大利异星人”Luca Stricagnoli 降临乐府！	暂不开放	广州
探东山少爷”的昔日韶光，觅小巷里的老广州美食记	户外活动	广州
"小周末让我们\""怦然星动\"""	派对聚会	广州
我们交换书吧，带我遨游你的书海	派对聚会	广州
TeamFun首届女神摄影大赛	派对聚会	广州
0基础成人钢琴99元3首钢琴曲！	沙龙学堂	广州
阖家团圆――五色汤圆	体验课	广州
手冲：GET一门高逼格技能	沙龙学堂	广州
古巴舞蹈大师带你零基础入门，体验南美风情Bachata	文艺生活	广州
个人专辑录制	暂不开放	广州
法语角02  初识浪漫法国人，像法国人一样打招呼2	派对聚会	广州
爱情浪漫号，白色情人节多肉花束DIY	DIY	广州
零基础，来学4款鸡尾酒玩玩呗	派对聚会	广州
过年留广州的朋友聚会呗	派对聚会	广州
桌游之夜-交友沙龙	派对聚会	广州
2月8日-2月12日早 三亚-亚龙湾-西岛-潜水-天涯海角	户外活动	广州
零基础英语发音体验课程	沙龙学堂	广州
【室内免费日语角】-五羊新城日语角欢迎您！	派对聚会	广州
樱花开了 相约新丰樱花峪缔造浪漫景色	户外活动	广州
不相亲，只谈爱的非诚勿扰版	派对聚会	广州
下雨天，红酒与牛腩火锅更配哦~	派对聚会	广州
最后3个名额~考拉食验室 | 奇妙化学夜”鸡尾酒派对	酒吧	广州
城市行报名 | 资深旅行者与客栈老板，会擦出怎样的思维火花【广州/深圳】	讲座沙龙	广州
来逛复古市集吧~！	派对聚会	广州
1.16分享会 | 2016的第一份礼物：带着舞蹈和三个她”去旅行	体验课	广州
创意软陶制作	DIY	广州
【城市猎人】1.31周日 岁末闯羊城，偶遇游大侠，疯狂暴走通缉令	运动健身	广州
【服装设计DIY】你和女神只差一条定制伞裙	DIY手作	广州
【1月22日】单身派对+K歌+交友+自助餐	派对聚会	广州
人像写真	商业	广州
OPEN CHAT！土耳其旅行分享会	讲座沙龙	广州
【赏梅啦！体验价70元/人】1.24周日行摄哈施塔特小镇，红花湖赏梅了	户外活动	广州
梦享影院《喜马拉雅天梯》	电影	广州
网球福利，周末教你来学网球周日场	运动健身	广州
周日、周三古巴大师带您莎莎Salsa舞入门！	文艺生活	广州
梦享影院《阿基尔，上帝的愤怒》	电影	广州
你的派对妆面，交给专业化妆师！	体验课	广州
美嘉7890回忆展――来这里找回你的童年	展览	广州
【穿越龙渔线】1.16周六：龙洞-乌子山-杓麻山-渔东路，华南第一坡练蹄！	户外活动	广州
【我图电影院・1月刊首语】一起反鸡汤	电影	广州
最悍，最厝岬摹敢妨髅ァ	音乐会	广州
在文艺画室里，画出属于自己的油画	文艺生活	广州
【穿越牛木线】1.9周六：牛木线练蹄，挥洒汗水宣扬青春	户外活动	广州
一起来弹唱尤克里里!!!	体验课	广州
实用心理学技术――潜意识投射卡	体验课	广州
成人零基础钢琴体验课，学习《卡农》	文艺生活	广州
优雅高尔夫初体验 99元赠球杆+手套+30分钟教学指导+100颗击球	运动健身	广州
【现代舞体验课】训练定形体，舞蹈定气质	文艺生活	广州
元旦品咖啡交友活动	派对聚会	广州
S.T.D. N.Y.E. ft. ONRA [LIVE]和法国音乐人一起过元旦	小型现场livehouse	广州
时尚观影_2015国际时尚年末总结	派对聚会	广州
【声音美容】――声音好听的人，运气不会差	体验课	广州
聚会新玩法，做一回冲上云霄”的主角！	派对聚会	广州
807有名堂 | 社工标：公益十年是一种什么体验？	讲座沙龙	广州
【新线首发】12月26日陪你去看海，徒步蔚蓝色的大亚湾海域海岸线――桔钓沙	户外活动	广州
元旦哪里玩？｜一起去跑卡丁车，感受赛车的味道	运动健身	广州
史上最好玩的桌游：现金流游戏	派对聚会	广州
优活起航永生花礼盒	DIY手作	广州
圣诞烘焙 | 圣诞DIY纸杯蛋糕	DIY	广州
零基础学鸡尾酒酷炫一把！	酒吧	广州
12.25白色圣诞派对【迷・鹿】	派对聚会	广州
一杯下午茶，并有专门摄影师为您记录与猫の日常	下午茶	广州
猴爱你音乐盒粘土DIY	DIY手作	广州
优活起航棒棒糖蛋糕DIY	DIY手作	广州
做一款长夹，送给TA做为贴身礼物	DIY手作	广州
圣诞前，来学个鸡尾酒玩玩呗！	派对聚会	广州
长隆马戏团之旅	DIY	广州
怀旧趴|约一群8090过来逗逼（脱单必看）	派对聚会	广州
考拉食验室|鲜牛油曲奇diy课程	DIY	广州
体验一次绘画大师，感受艺术生活	DIY	广州
11.21周六：财商大作战――现金流桌游（社交活动）	派对聚会	广州
周日职业人进修课堂：《 以一张画布”规划全新的自己》	讲座沙龙	广州
经典星溪线徒步，穿越从化溪头村	户外活动	广州
这里，不仅仅是咖啡馆	派对聚会	广州
文艺范零基础油画	派对聚会	广州
我图小沙龙：11月7日电影《暖暖内含光》	电影	广州
第3期|梦想头脑风暴	派对聚会	广州
【我图小沙龙】如果这周六你正好有空，我们一起看《教父》吧	电影	广州
挑战最强大脑，让魔方在指尖酷炫翻转	派对聚会	广州
小光棍节特别策划―预热脱光 哈斯塔特小镇拍拍拍 牵手骑行红花湖	户外活动	广州
【零基础服装设计】画出你的dream dress	文艺生活	广州
【我图茶话会】银行业务排名第一到辞职到参学传统文化那些有趣的事	讲座沙龙	广州
韶关赏银杏，寻找秋天的童话	户外活动	广州
11.05周四 |发现你的好声音（个人魅力）	暂不开放	广州
哎呦喂！这个花瓶不错哦！	DIY	广州
财商大作战――现金流桌游（社交活动）	派对聚会	广州
美食与爱之为女友下厨	DIY手作	广州
2015年失踪周末最新赏银杏活动（已报够人）	户外活动	广州
学钢琴，当然要从理论学起	派对聚会	广州
【我图茶话会】10月11周日：台湾交流生的所见所想	讲座沙龙	广州
【三店通用】专业成人钢琴20节课299元 名师一对一上课	文艺生活	广州
20元教会你2首钢琴曲，1对1双手弹奏	文艺生活	广州
【10.4-5】两轮月亮湾―双月湾，狮子岛（可住宾馆）	户外活动	广州
双月湾露营 狮子岛 相聚两轮湾月 可住酒店	派对聚会	广州
零基础学调创意魔术鸡尾酒	DIY	广州
零基础油画活动：Leonid Afremov 《水中风车》	派对聚会	广州
【品酒会】|当红酒遇上牛扒时	DIY手作	广州
财商大作战：现金流桌游	派对聚会	广州
【国庆】梦幻哈施塔特 骑行红花湖18KM	户外活动	广州
【9.20 周日 】蝴蝶谷新谷戏水，相聚传说中的溯溪圣地	运动健身	广州
花漾寿司学堂|教你DIY花式寿司	DIY手作	广州
【龙脊之秋】徒步醉美龙胜梯田 游赏绿色水稻	派对聚会	广州
旧电影+小伙伴= 周末一起懒	派对聚会	广州
【我图小沙龙】周六电影「2001太空漫游」	电影	广州
Titanic Time！电影+游戏+美食=周末交友趴	派对聚会	广州
一起嗨！史上最嗨的泡泡足球	运动健身	广州
【我图电影院】周三电影「攻壳机动队」	电影	广州
【中秋9.26-9.27】访千年瑶寨 行摄梯田 寻最美古村落	派对聚会	广州
人民币贬值了，你应如何改变理财策略？	派对聚会	广州
巧克力心太软蛋糕：我有一颗柔软如琼浆的心	DIY手作	广州
牛爷爷说：自然界任何两个物体都是相互吸引的【女生已满，男生可报名】	派对聚会	广州
炸鸡啤酒，今天来一回「饺子啤酒」，最后来个「桌游」醒醒酒	派对聚会	广州
【SélectArt】零基础油画活动： 吴冠中 ・《江南水乡》	派对聚会	广州
【秋醉】cocktail！零基础都能学的酷炫鸡尾酒	派对聚会	广州
决战白云之巅，撕名牌系列大战，伐木累！	运动健身	广州
【9.3广州】吃货大反斗之进击上下九步行街	DIY手作	广州
秒杀荧光跑，酷到没朋友 ・ 创意荧光夜跑	运动健身	广州
奇妙芝旅 ・ 芝士蛋糕DIY（可两人使用）	DIY手作	广州
【我图电影院】周三九月主题：科幻迷梦「机械姬」	电影	广州
【简直丧心病狂的好玩啊！ 】139元体验各种漂流刺激和欢乐，感受到纵情自然的无穷乐趣	运动健身	广州
游千年黄姚，梦回半生缘	派对聚会	广州
【电影小沙龙】905周六「人工智能」	电影	广州
3天2夜，超值玩转贺州	派对聚会	广州
PINK FLOYD 纪念音乐会 广州SD	暂不开放	广州
【9.4广州】奔跑@生化危机：你，准备好迎接一场硬战了吗？	运动健身	广州
胜利日?探寻中国最美火山岛「硇州岛」	派对聚会	广州
胜利日?龟龄岛露营看海 守候日落日出	派对聚会	广州
「干掉压力」枕头大战摇滚夜！ 广州站	暂不开放	广州
醉美阳朔 慢游漓江 遇龙河漂流 情遇西街	派对聚会	广州
一份可以「晒」的礼物 X 鲜香草牛油曲奇diy活动	DIY手作	广州
酥皮烤牛柳：天地都在这一包一裹之间	派对聚会	广州
大夫山，骑行寻宝	运动健身	广州
催眠体验沙龙：同步未来，遇见未知的自己	派对聚会	广州
甜趣之旅：DIY卡通印花曲奇	DIY手作	广州
嗨起来！美食和游戏，还有真正的美国 Crazy English Party！	派对聚会	广州
【国庆】柔软的细沙，迷人的双月湾	派对聚会	广州
手把手教你在朋友圈招桃花	派对聚会	广州
咖啡制作体验，亲手为自己冲一壶精品咖啡，过有情趣的生活	DIY手作	广州
中秋在即，冰皮Q弹月饼自己做更好(已满人)	派对聚会	广州
【饭醉团伙】零基础都能学调酷炫鸡尾酒！	DIY手作	广州
【天天夜跑】跑步者的荧光Party，我们一直在路上！	运动健身	广州
嗷~~狼人之夜，与陌生人一起玩桌游	派对聚会	广州
【确定出行国庆10.2-4】醉美阳朔 慢游漓江 情遇西街 遇龙河漂流	派对聚会	广州
「双人套餐」释放无限活力，蜕变一个不一样的你！	运动健身	广州
职业咖啡师教您DIY花式咖啡，送给心仪的Ta	DIY手作	广州
4天3夜：徒步武功山，行于天上草原，赏日出云海	派对聚会	广州
「完美世界」 金玟岐 2015首唱巡回音乐会―广州站	暂不开放	广州
一支画笔一杯咖啡，绘画你也如此深爱	派对聚会	广州
我有一个小星球，仿佛是童话里的一个水晶屋：微景观DIY	DIY手作	广州
醉美风景在这里，美到心醉的英西阳山	派对聚会	广州
【胜利日】情迷大丹霞：牛鼻村+巴寨+王屋大环线	运动健身	广州
【国庆】珠海高栏岛，有风车有沙滩还有意想不到的美景	派对聚会	广州
「Her Bright Skies」 首次中国巡演―广州站（预售票已售完）	暂不开放	广州
纸花儿Diy：生活如此美好，手工如此简单	派对聚会	广州
我图大剧院：周六「最好的时光」	电影	广州
一起看牛轰轰的电影：8月19日周三「再见列宁」	电影	广州
七夕，不要再自己一个过了！魅惑迷情红唇单身派对与你相约	派对聚会	广州
醉美风景在这里，美到心醉的英西阳山【名额有限提前下单】	派对聚会	广州
考拉七夕：巧克力流心蛋糕Diy	DIY手作	广州
我教拉花，你喝咖啡	派对聚会	广州
探索你的能量场，开放内心真正的自我	沙龙学堂	广州
惬意的午后，亲手制作一份下午茶吧 ！DIYの轻芝士蛋糕	DIY手作	广州
【我图变奏夜】818周二七夕特别活动：一场清醒而浓情的爱情实验	派对聚会	广州
我图大剧场：周六「海上花」（八月主题：漫漫长诗侯孝贤）	电影	广州
【爱上你的・绚烂笔触】ArtHouse 零基础油画课程	派对聚会	广州
【我图变奏夜】周二 非文艺桌游之夜	派对聚会	广州
【我图电影院】8月12日周三「伊甸湖」	电影	广州
【徒步看海】珠海眺望飞沙滩，小三浪到高栏港看大风车	派对聚会	广州
【情侣装体验课程】和ta秀恩爱才是正经事	DIY手作	广州
【我图大剧场】8月每周六漫漫长诗之侯孝贤专场	电影	广州
平面的绘本还能再提升一个层次？一起来画3D彩铅画！	派对聚会	广州
【我图电影院】雾夜的夜・男神回归计划：「三只猴子」观影	电影	广州
闲时光，陶艺全过程体验，享受慢时光	DIY手作	广州
甜蜜芝旅：DIY CupCake 纸杯蛋糕	DIY手作	广州
一个有阳光的阳台，一个有你的家	派对聚会	广州
永生花3D画框	DIY手作	广州
做一个胖乎乎软绵绵的蛋糕卷	DIY手作	广州
把小微景观林装进我的玻璃球	DIY手作	广州
沙画体验课：指尖上的沙画艺术，玩转沙子世界！	派对聚会	广州
专属你的旅拍：让旅行如绚烂夏花	派对聚会	广州
【海岛旅行】龟龄岛露营 篝火晚会 烧烤大餐	派对聚会	广州
DIYの创意彩绘蛋糕卷	DIY手作	广州
40元教会你2首钢琴曲，激扬你的音乐梦	文艺生活	广州
指尖上的艺术：粘土手作【赠送精品咖啡】	DIY手作	广州
【海岛旅行】奔跑吧！龟龄岛露营看海  撕名牌大战	派对聚会	广州
【微占卜】微信塔罗占星已开启，解开命运之谜	派对聚会	广州
【醉过】夏日Cocktail！零基础学调酷炫鸡尾酒 第⑥弹	派对聚会	广州
旧电影+葡萄酒+小伙伴=周六进行	派对聚会	广州
【千年古镇旅行】走进黄姚古镇 梦回故乡半生缘	派对聚会	广州
溪头村溯溪 远离城市的喧嚣	派对聚会	广州
每周四 | 手牵手相约在冰面飞翔	运动健身	广州
45分钟即兴创作一首属于自己的钢琴曲	文艺生活	广州
亲手打磨一个属于你的精灵吧	派对聚会	广州
HiClass 鲸鱼手机底座制作	DIY手作	广州
零基础90分钟学会肖邦钢琴曲一首｜时尚钢琴成人钢琴课	文艺生活	广州
MEOW Handmade手工皮艺 | 可以用一辈子的木扣笔记本	派对聚会	广州
Ukulele1元体验课，一小时内自弹自唱	体验课	广州
【简直丧心病狂的好玩啊！ 】129元体验各种漂流的刺激和欢乐，感受到纵情自然的无穷乐趣	运动健身	广州
让你的耳朵释放压力吧！ | 集乐队「电金核」EP首发巡演	暂不开放	广州
「假期清凉一夏」狮子头溯溪泡潭，浪琴湾沙滩踏浪	运动健身	广州
驰骋万亩大草原，探访苗寨与苗家女共舞	运动健身	广州
假如你的世界是立体的，一起走进3D的殿堂	派对聚会	广州
专业零基础成人钢琴299元 20节课 打造你的钢琴梦	文艺生活	广州
{ 手创时光 手作课 } 浪漫固体香水	派对聚会	广州
预售：「有事发生」演唱会	暂不开放	广州
让个人都可以弹出自己喜欢的钢琴曲 | 成人钢琴基础乐理知识【保证教会】	文艺生活	广州
美拍| 带上Ta 游走惠州西湖 行摄奥地利小镇一日游	运动健身	广州
悦泽课堂｜茶艺 体验课，感受东方传统茶文化	派对聚会	广州
茶道培	茶会雅集	贵阳
世界名曲轻松上手  成就你的钢琴梦想	文艺生活	哈尔滨
哈尔滨也可以学习潜水啦	运动健身	哈尔滨
"Keep Walking,冰城江畔路万人徒步健康行"	运动健身	哈尔滨
生如夏花・羊毛毡胸针	DIY手作	杭州
大禹谷-娘娘山穿越，赏长乐林场红叶，甘岭湖野	户外活动	杭州
11.19黄南古道看尽最美红枫，再不出发，秋天就要溜走了	户外活动	杭州
11.19 豪情穿越皖南龙须山脊，挑战与美景并存	户外活动	杭州
韩式美妆单节体验课 | 画一个美美的韩式清新裸妆去约会吧~	沙龙学堂	杭州
用一间客栈，温暖一座山――长白山4天3晚	户外活动	杭州
11月12日 品酒小白葡萄酒入门课程	沙龙学堂	杭州
11.20 这个曾被全世界瞩目的避世圣地，秋天的颜值也是逆天	户外活动	杭州
【双十一特惠，买一送一】11.13周天，莫干山踏秋	户外活动	杭州
【一击即中】每周三晚， 离开电脑，放下手机，  深呼吸，开弓射箭	运动健身	杭州
11.6 漫步唐诗古道――栖霞坑，赏红枫，走松针”小道	户外活动	杭州
用羊毛毡手工做你最爱的猫咪	DIY手作	杭州
【11月05日 】简爱陌生人饭局之浙江人专场 | 浙江人和浙江人在一起约火锅啦	派对聚会	杭州
【每天一勺】陶艺不规则勺子 | 用自己亲手制作的勺子吃饭会不会特别美味呢？	DIY手作	杭州
阳产晒秋，古村漫步，皖南古村满山菊花	户外活动	杭州
这个来自2000米以下的海底温泉，全球只有23个地方有！	户外活动	杭州
手工皮具 | 一款精致的长款钱夹，是生活中最好的点缀	DIY手作	杭州
亲子秋游：轻徒步+穿越绳林，长乐林场走起	户外活动	杭州
【全城戒备】杭城某神秘山顶防空洞内，将涌现大批丧尸……	派对聚会	杭州
大理・绿社4天3晚度假定制体验 风花雪月里虚度时光	户外活动	杭州
女人的优雅，是妆”出来	沙龙学堂	杭州
学习韩国彩妆 | 妆”饰自己，化”出美	沙龙学堂	杭州
Psychic Halloween｜万圣地下音乐派对	派对聚会	杭州
10.22趁着10月徒步时节，跟着旅行达人去徽杭古道感受行走的力量吧	户外活动	杭州
冰川石瀑10.15 登覆卮山，踏第四世纪冰川，赏千年梯	户外活动	杭州
最忆是杭州-寻找一座城的美	户外活动	杭州
10.15周六，徒步东白山大环线，草甸巍峨，芦苇飘荡	户外活动	杭州
公益抑郁症心理治疗：一对一心理咨询 | 请放下内心的不安和不信任感	沙龙学堂	杭州
扎染围巾：蓝印花布永恒的经典	派对聚会	杭州
【绿野仙踪】10.23 飞越千丈幽谷，寻找江南欧米伽大拐弯，探秘倒脱靴	户外活动	杭州
【志趣社国庆特辑】10.3-10.4 | 精致下午茶制作	DIY手作	杭州
【特价:大明山红枫】 大明山景区秋季赏红枫， 坐超级滑滑梯，走悬空栈道！！	户外活动	杭州
染叙――扎染布包	DIY手作	杭州
来高端录音棚，录制一首自己爱的单曲吧！	文艺生活	杭州
【国庆特辑】 10.5-6 未经开垦的处女地――东旦沙滩，露营、篝火	户外活动	杭州
【风车芦苇】11.13秋风起，芦苇飞，风车情缘定东白山	户外活动	杭州
成人钢琴精品课，佳丽名媛专属轻奢休闲天地	沙龙学堂	杭州
【国庆短线】10.2 纪龙山 速降+岩降+探洞 上演真实版盗墓笔记	户外活动	杭州
第二十五期心灵分享会：致身边抑郁的朋友	沙龙学堂	杭州
烘焙课 | 中秋味道，手作广式月饼（9月16日）	DIY手作	杭州
睿智人生，职场能手――从高端私人定制的职业规划开始	沙龙学堂	杭州
睿智人生，职场能手：从高端私人定制的职业规划开始	沙龙学堂	杭州
【野趣徒步】11.19 大明山 万米岩洞+超级滑滑梯+悬空栈道！	户外活动	杭州
【志趣社】9.13 | 中秋豪礼！自己做冰皮月饼!	DIY手作	杭州
生活美学一站式体验  ~史上性价比超级高的派对聚会~	派对聚会	杭州
【绿影仙踪】真假兰若寺，探访上青古道，竹林幽幽绿显踪	户外活动	杭州
陶艺：捏花浮雕陶瓷――完美开启你的艺术之旅	文艺生活	杭州
陶艺――手工制作陶瓷项链首饰	DIY手作	杭州
长白山追寻最自然的风光	户外活动	杭州
日本风情体验 | 零基础也能轻松上手的外教日语沙龙体验课	沙龙学堂	杭州
青少年羽毛球体验课 | 全面锻炼少年人的身体素质	运动健身	杭州
单身交友活动之浙江人专场	派对聚会	杭州
防身术加强班: 散打 拳击 自由搏  实战跆拳道 空手道	运动健身	杭州
拒宅主义 || 周二晚 夜走环西湖，相约一起来锻炼身体，交友	户外活动	杭州
一对一KTV麦霸唱歌速成培训体验课报名啦！	文艺生活	杭州
【拒宅主义】周三晚 (升级版)荧光夜走钱塘江，看G20期间钱江新城夜景	户外活动	杭州
手工皮具体验 | 做一个属于自己的牛皮短夹吧	DIY手作	杭州
这个夏天你需要一把独一无二的扇子	DIY手作	杭州
夏天吃不胖 | Gelato品鉴大会，每种口味都那么诱人~~	派对聚会	杭州
8/6 一百元干啥呢？当然是喝酒咯！！	派对聚会	杭州
两天一夜 | 9.15-9.16 你说你喜欢大海，我们就把RM挑战搬到舟山	户外活动	杭州
穿山越水，没有性感锁骨，也可以它为傲。	DIY手作	杭州
陌生人饭局之学霸专场	派对聚会	杭州
夏天画个葫芦喝水吧	文艺生活	杭州
神秘的阿拉伯――舌尖上的G20沙特阿拉伯站	DIY手作	杭州
【夏季滑雪】逛鲁讯故居，在夏季一起来玩滑雪	户外活动	杭州
玩转德意志――舌尖上的G20德国站	DIY手作	杭州
大师教你学钢琴  ， 快速晋级钢琴大咖	文艺生活	杭州
【特价活动】8.27-28日二天  逃离城市，藏匿于深山，括苍山看第一缕曙光及云海	户外活动	杭州
夏日特价 | 8.6 夏天哪凉快就待哪！这个避暑圣地当地人都不肯声张！	户外活动	杭州
致爱茶的你 | 在微醺的暖风中泡一壶清茶	茶会雅集	杭州
全民冰上打雪仗，任性开打 | 夏天也能打雪仗，都玩嗨了！！！	派对聚会	杭州
【游戏旅行】谋杀之谜：LARP平行世界，桐洲岛连环杀人事件	户外活动	杭州
7.10 俯瞰大地，富阳相约一起来玩滑翔伞(史上最低)	户外活动	杭州
【夏季漂流】7.17周日，神龙川峡谷休闲度假，月亮湾皮艇激情漂流，清凉一夏！	户外活动	杭州
【线上微活动】走进大师的水墨世界，一节课告别书法小白	沙龙学堂	杭州
NewBe单身趴|遇见一个人，今年七夕一起过	派对聚会	杭州
暑期干什么？看这里！！绘画，审美，设计，两周时间足够让你拥有	文艺生活	杭州
今夏最IN室内运动――射箭	运动健身	杭州
这个夏日，相约轻熟女	派对聚会	杭州
Ella参与过的跑男原版线下推理游戏	派对聚会	杭州
【线上微活动】以美呼唤自由，理想与情怀的欣然邂逅	文艺生活	杭州
情迷意大利 a Little Romance――舌尖上的G20意大利站	DIY手作	杭州
杭州千岛湖直升机空中观光	户外活动	杭州
射出一个万紫千红	运动健身	杭州
同城特惠 | 杭州浪浪浪水公园开放，85元一起出发去浪！	户外活动	杭州
仅需158元    世界名曲轻松上手，成就你的钢琴梦想	文艺生活	杭州
趣・玩｜这么美的老师，带你链”接法兰西宫廷！	DIY手作	杭州
小白必须品酒技巧：葡萄酒入门课程	沙龙学堂	杭州
一沙一世界|沙画体验课	DIY手作	杭州
漂流特价 | 6月25日 139元无限杨梅采摘，勇闯百岁峡抢滩漂流	户外活动	杭州
伊斯坦布尔假期brunch――舌尖上的G20土耳其站	DIY手作	杭州
【疯狂夜袭西塘】8.13 看西塘夜景，邂逅西塘酒吧	户外活动	杭州
【线上微活动】 合适自己的才是最好的，找到属于自己的穿衣风格~	派对聚会	杭州
夏日作战 | 影视城上演RM挑战，香榧公园高空索桥漂流探险	户外活动	杭州
【陶艺微景观】把心中的美景变为手边的花园	DIY手作	杭州
11.19-11.20 两天一夜 | 一条自带颜值的小海港线路，一般人都玩不到这儿	户外活动	杭州
一个惬意的午后，一幅绘画作品，还有一群有趣的朋友	文艺生活	杭州
吃货大福利之世界顶级巧克力品鉴	沙龙学堂	杭州
妞妞们:一起来为自已缝制一条优雅的万能小黑裙吧	DIY手作	杭州
这么多年了，你还是一个人……	派对聚会	杭州
Weholic咖啡分享沙龙	沙龙学堂	杭州
趣・玩｜卡片为梭，织就最北欧的线条	DIY手作	杭州
探戈舞 | 释放都市压力  展现你的优雅	文艺生活	杭州
舌尖上的G20韩国站――泡菜大战思密达	文艺生活	杭州
杭州唯一的室内棒球体验馆 | 击球三连杀，一记全垒打	运动健身	杭州
舌尖上的G20印度站――宝莱坞＆玛莎拉之夜	文艺生活	杭州
【古道徒步】（已成团） 6.19走马岭古道，赏新光古村	户外活动	杭州
少儿剑道夏令营-做回小武士	运动健身	杭州
趣・玩｜会呼吸的蛋糕！用它虏获爱人的胃	DIY手作	杭州
圆你武士梦-剑道体验活动	运动健身	杭州
【端午特惠】6.11 水上漂流探险运动---雅鲁探险漂流特惠	户外活动	杭州
匠人手作陶艺器皿	DIY手作	杭州
千岛湖露营音乐节+古城寻宝，一起揭开隐藏在水下千年古城的秘密	户外活动	杭州
鸡尾酒有这么多，不要每次去酒吧只会点长岛冰茶了！！	文艺生活	杭州
木夕沙画体验课	文艺生活	杭州
夏日必备|驱蚊又除霉的香包	DIY手作	杭州
爱情36问”邂逅最美爱情	派对聚会	杭州
陶艺体验：重塑生活的纯粹，以陶之名！	DIY手作	杭州
【儿童玩具艺术展】童年时光机，以再见之名，让你的玩具重获新生！	派对聚会	杭州
采薇坊手造和香，中药香珠香牌DIY	DIY手作	杭州
制胚 ，上色 ，上釉 ，烧制，完整的做一件陶艺作品	文艺生活	杭州
【行者无疆】10.4   东白山，在蓝天和白云下追逐风车	户外活动	杭州
制作一件属于自己的皮具作品	DIY手作	杭州
入梅时节，静守内心【六一节的印记】	DIY手作	杭州
【花语之恋】桐庐赏薰衣草花海，登大奇山森林公园	户外活动	杭州
【抽屉第二十七期】来自黑森林的邀请函	派对聚会	杭州
【皖南秘境】5.28周六，穿越十门九不关雄伟石门群，登光明顶，看武侠传奇”	户外活动	杭州
第二十一期心灵阳光分享会|亲密关系中，男人为什么总爱沉默	沙龙学堂	杭州
520【爱情】是一件小概率事件| 做一件只属于你们的陶艺手作	DIY手作	杭州
【城市趣跑】趣味彩虹跑，你的青春就该这么浪！	运动健身	杭州
茶蕴琴声里，一起读四书	茶会雅集	杭州
巴西战舞Capoeira培训9月开始报名了	运动健身	杭州
第二十期心灵分享会――如何平衡自信与自卑	沙龙学堂	杭州
夏之物语 零基础制天然貌美植物手工皂	DIY手作	杭州
与文老师的一杯咖啡时间――心灵的沟通	沙龙学堂	杭州
特价99元 | 5.21 去长三角最刺激的雅鲁漂流探险，观千亩七彩百合绽放	户外活动	杭州
【户外探险】9.15 盗墓笔记”真实版――纪龙山速降，探洞！	户外活动	杭州
Newbe单身趴 | 喂，单身太久是会被杀掉的	派对聚会	杭州
服饰搭配体验 | 最美的自己才是最好的礼物	文艺生活	杭州
陶艺制作：手工多肉盆，还送好多肉，不能吃哦！	DIY手作	杭州
电影沙龙番外两篇――短片《春风》《囚》	文艺生活	杭州
【五一】别样千岛，环湖骑行皮划艇，湖边烧烤五星级露营	户外活动	杭州
极力推荐：大明山野外生存线路，野味十足！	户外活动	杭州
在离心脏最近的地方，留下你的专属印记	DIY手作	杭州
浪客剑心，体味剑道之义|月卡（12次）	运动健身	杭州
【满山杜鹃】5.1，徒步三国吴魏边界，赏高山杜鹃，道场坪环线	户外活动	杭州
这瓶子里有座花园---微景观	DIY手作	杭州
尝试新鲜事物――相约一起去玩射箭	运动健身	杭州
轻装徒步 | 4.23 穿越吴越古道，勇闯浙北三关，探秘浙西天池	户外活动	杭州
手冲咖啡，教你把咖啡玩出新高度	DIY手作	杭州
游走四明山杖锡村，许愿万亩樱花树下，享古村慢时光	户外活动	杭州
国庆特辑 | 10.4 为你插上飞翔的翅膀，带你装逼带你飞！	户外活动	杭州
别宅啦 徒步黄龙洞，拥抱大自然，畅谈春意！	户外活动	杭州
植物浮雕，将美丽的瞬间刻画在永远！	DIY手作	杭州
4月15日 RR约你痛快畅饮新西兰百年精酿！	讲座沙龙	杭州
摇滚夜｜4月15日，波兰乐队ROAN摇滚趴	暂不开放	杭州
听说玩乐器跟夏天更配|吉他、尤克里里、电钢体验	文艺生活	杭州
在城市中飞檐走壁	运动健身	杭州
小小理财师	体验课	杭州
真假兰若寺，探访上青古道，竹林幽幽绿显踪	户外活动	杭州
镇宅避邪吉年马勺脸谱制作	DIY手作	杭州
"春游龙池山，低碳清新悠游骑行,城市短暂逃跑"	户外活动	杭州
有眼市集HANGZHOU〈潘洛斯阶梯〉	市集	杭州
4.9  纵穿新昌石门幽谷，徒步险峻虎脊背	户外活动	杭州
韵海茶山行：寻觅云上人家 感知山中传奇	户外活动	杭州
暑假必备：手工陶艺紫砂盘泥DIY体验制作	DIY手作	杭州
走！打高尔夫去	运动健身	杭州
登第四世纪冰川遗址，覆卮山石赏油菜梯田	户外活动	杭州
闻香品茗，止语抄经，大隐隐于市的'轻禅'生活	体验课	杭州
乘热气球飞跃千岛湖  云中漫步	运动健身	杭州
夜航船读书会第三十六期――《生命是什么》	派对聚会	杭州
【三字禅&品茶会】喝（勇哥）的下午茶	None	杭州
青出于蓝而胜于蓝---草木染	DIY	杭州
杭州最燃的春天 ― Awaken觉醒?鹦鹉螺春季创意市集	文艺生活	杭州
第十四期心灵阳光分享会：找回属于我的那份自信	文艺生活	杭州
小河直街RM游戏，感受旧日里的光影变幻	派对聚会	杭州
静学社花艺课程------初阶十课	DIY手作	杭州
歆然教育-天籁童声歌唱精品课	沙龙学堂	杭州
左扭扭，右扭扭之肩颈按摩操	运动健身	杭州
踏春之|3.20 尼玛~这是要上天啊!!!	户外活动	杭州
【行者无疆】乌石山徒步，感觉不一样的挑战	户外活动	杭州
花开春暖 | 桐洲岛上慢生活，荻浦花海拍大片	户外活动	杭州
周末学一门乐器--尤克里里速成	文艺生活	杭州
品酒小白必学技能！	沙龙学堂	杭州
妮红酒电影 | 一场关于放松的诉说	电影	杭州
植树节特辑 | 一起搭伙烧饭、植树许愿；还能撕名牌、玩攀岩挑战	户外活动	杭州
【莓你不行】3.19是周六  一起去春游吧~	户外活动	杭州
为什么选择社交拉丁舞之基础课程篇	运动健身	杭州
儿童全脑钢琴精品课 | 愉快的亲子课堂发掘孩子们的音乐天赋	沙龙学堂	杭州
【行者无疆】3.6 千亩梅花竞相艳，梅花沟休闲摄影徒步	户外活动	杭州
"第三季 | 周末中午啪,啪,啪”活动回来啦~"	运动健身	杭州
B2 EVENT | 设计公益海报佳作展「初印象」	展览	杭州
妮红酒电影 | 做一个享受生活的人。	电影	杭州
钢琴，并没有想象的那么难~~成人钢琴精品课，等你来嗨皮哟！	沙龙学堂	杭州
C大调调酒教室――相遇便是缘	体验课	杭州
活动|长期举办――与文老师的一杯咖啡时间	文艺生活	杭州
最美好的新年礼物，我要为你亲手做！	DIY	杭州
七彩元宵”音乐游园会	户外活动	杭州
2月27日 年后充电之旅：葡萄酒初级品酒课	讲座沙龙	杭州
发掘内心的自己-社交拉丁舞体验课	运动健身	杭州
【情人节】玩转油画|趣味互动游戏|享浪漫双人烛光晚餐	派对聚会	杭州
田鸡咕咕 ： 一位乡村婆婆的回忆	展览	杭州
让孩子在自信和快乐中学习钢琴，零基础钢琴免费体验	体验课	杭州
午后，邂逅一树花开	文艺生活	杭州
11/19 葡萄酒盲品品鉴会！	派对聚会	杭州
也许是 杭州最好玩的 单身年会！	派对聚会	杭州
调酒教室―― 邂逅、青春	体验课	杭州
快乐的画・黑白配――零基础超值素描	DIY	杭州
活动|与文老师的一杯咖啡时间	体验课	杭州
爱上光和色的明媚――零基础超值油画	DIY手作	杭州
【行者无疆】徒步昌化古道，探秘云顶冰湖	户外活动	杭州
巴洛克风格马赛克烛台定制DIY	DIY手作	杭州
C大调调酒教室――只是想念，偶尔的想念	体验课	杭州
乐趣引发兴趣，舞蹈实现燃脂，打造绝妙身材！	运动健身	杭州
杭城最潮RM游戏，看嗨了别怪我！--本期游戏！完全抄袭”running man！	派对聚会	杭州
快乐的画・以黑为白――零基础超值素描	DIY	杭州
年末特辑 | 7星级真古温泉，漫步枫泾古镇！	户外活动	杭州
调酒教室――杯酒岁月	体验课	杭州
飞跃太子尖，马啸岭笑傲江湖，狂啸三千里	户外活动	杭州
1月9日 RR助你变身品酒达人！	讲座沙龙	杭州
快乐的画・绘光年――零基础超值油画	DIY	杭州
快乐的画・元旦快乐――零基础超值油画	DIY	杭州
芦花飞舞，最美风车，草甸巍峨―― 东白山徒步	户外活动	杭州
周末法式派对・1945美军航拍中国图片分享会	派对聚会	杭州
杭州草地音乐会2016新年PARTY	小型现场livehouse	杭州
调酒教室―时光荏苒，蹉跎了谁的年华	体验课	杭州
常州恐龙园、恐龙谷温泉、迪诺水镇、吃喝玩乐嗨翻天！	户外活动	杭州
入门级经典：徽杭古道一日轻松徒步，看春天里的徽杭风景	户外活动	杭州
体验英伦时尚室内运动之王壁球的魅力	运动健身	杭州
一起去看流星雨，跨年守望2016第一缕曙光	户外活动	杭州
元月9号 临安大明山滑雪季，畅享滑雪	户外活动	杭州
调酒教室―冬日里的一次完美邂逅	体验课	杭州
12-25圣诞变装派对等你来嗨！	酒吧	杭州
西湖区 | 陌绘&火炙鸟 圣诞的余温	派对聚会	杭州
第七期阳光心灵分享会：现在，你想对自己的童年说什么？	派对聚会	杭州
香颂交友会2015岁末温馨派对?重温情路	派对聚会	杭州
每周六下午狼人真人版事件游戏	派对聚会	杭州
长期举办|与文老师的一杯咖啡时间	文艺生活	杭州
攻占千倾关，走天龙大峡谷；吴越古道一日徒步	户外活动	杭州
快乐的画・黑白世界――零基础素描活动	派对聚会	杭州
调酒教室―恰逢?思念	体验课	杭州
双12以梦为马桌游半价！	派对聚会	杭州
滑翔伞+撕名牌等+交通359元全包	运动健身	杭州
快乐的画・素雪铅华――超值素描活动	派对聚会	杭州
快乐的画・岁月成花――超值油画	派对聚会	杭州
周末下午茶―温馨法式派对	派对聚会	杭州
爆炸毅行第N波：12月13日浙大玉泉-北高峰-法喜寺-龙井村-九溪	户外活动	杭州
飞檐走壁！感受一下什么叫蜘蛛人”――室内攀岩	运动健身	杭州
画事，不跟随/与你邂逅在拉姆	派对聚会	杭州
狂嗨海洋全景魔幻乐园，只要119哦	派对聚会	杭州
快乐的画・初雪画卷―超值油画活动	派对聚会	杭州
调酒教室――指间划过的时光	派对聚会	杭州
两天一夜 | 醉享温泉，黄山五星豪华之旅	户外活动	杭州
凤凰山玉皇山南宋文物考?福星观听晚课	户外活动	杭州
【轻装健行】12月6 相约东白，一起在风车和蓝天下放逐	户外活动	杭州
Paintmore陌绘&火炙鸟 樱花树下的约定	派对聚会	杭州
调酒教室―辗转已成流年	体验课	杭州
79元！下周六与温泉有个约会！	派对聚会	杭州
「感恩礼物」带着妈妈来变美！	讲座沙龙	杭州
要瘦，要瘦，要瘦！重要的事说三遍！	运动健身	杭州
风靡全美的小团体私教班袭杭，打造维密的魔鬼身材	运动健身	杭州
快乐的画・感恩相约――超值油画活动	派对聚会	杭州
十里红枫霜漫天，秋色无边――磐安十里红枫，银杏古道	户外活动	杭州
每周三晚，你说你的故事，我请你喝我的酒	酒吧	杭州
【翻山越岭】4月23 徒步穿越徽杭古道，结交新朋友	户外活动	杭州
快乐的画・冬日绘卷――超值油画、素描活动	派对聚会	杭州
我想和你分享这一口甜蜜--香橙玛德琳	DIY手作	杭州
【红樽坊初级品酒课】11月，让我们向学霸迈进吧！	派对聚会	杭州
C大调调酒教室―落痕浅淡，指尖抚唇	体验课	杭州
【牧野户外】11月21日 逛江南新市古镇，观下渚湖芦花漫天	户外活动	杭州
每周六晚一起约桌游，交朋友	派对聚会	杭州
快乐的画・超值油画、素描活动-如约	DIY	杭州
2015ADM（亚洲设计管理论坛暨生活创新展）大展 原创家居体验站	展览	杭州
阳光心灵分享会第一期：今夜，我想被听见	派对聚会	杭州
这可能是杭城万圣节最好玩的活动了！	派对聚会	杭州
万圣节单身交友烘焙主题趴	派对聚会	杭州
另类玩法，和心理师玩转杀人游戏，体验心理	派对聚会	杭州
做型男，从修眉开始	文艺生活	杭州
10.25 免费船游七里扬帆，还送三都蜜桔采摘	户外活动	杭州
国庆特辑 | 10.3 纪龙山速降，盗墓卧龙洞，热血沸腾之旅！	户外活动	杭州
浮雕效果的神奇画作，纸浆画DIY	派对聚会	杭州
烘焙~手工蔓越莓饼干，甜甜的滋味	派对聚会	杭州
10.18 漫步大禹谷，赏苕溪芦花一日白	户外活动	杭州
10月18日登顶覆卮山-踏第四世纪冰川石浪，足700亩千年梯田	户外活动	杭州
万圣节狂欢夜，全家一起High翻天！	派对聚会	杭州
【1月活动】成人钢琴课携伴而来”2人均享免单!	体验课	杭州
花开时节学插花，给生活来点高雅的艺术吧	文艺生活	杭州
「红樽坊初级品酒课」10月开课啦！！	派对聚会	杭州
武功山三日穿越，满山黄草萧瑟行	运动健身	杭州
国庆 | 苏州太湖迷笛电子音乐节，随心所欲！	暂不开放	杭州
10.31，徒步东白山大环线，草甸巍峨，风车飞舞，芦苇飘荡	运动健身	杭州
外婆的钩针编织，钩出童年的画面	派对聚会	杭州
中秋西子邀明月 丝竹昆曲夜行船	派对聚会	杭州
【绿野仙踪】9.27周日，新昌飞越千丈幽谷，寻找江南欧米伽大拐弯，花径浪漫徒步！	运动健身	杭州
9月27日  微旅行 | 三台山寻梦，乌龟潭探野，在花圃邂逅一场桂花雨	户外活动	杭州
【活力周三】相约陈经纶游泳馆，做一条鱼，横越大海	运动健身	杭州
相约湿身蝴蝶谷，山泉里游泳	运动健身	杭州
零基础画国画，绘一副花鸟图	派对聚会	杭州
紧跟《爸爸回来了》、《虎妈猫爸》的步伐，亲子剑道体验开放！	运动健身	杭州
真的很赞！点进才知道原来......	派对聚会	杭州
9月12-13 登顶清凉峰，一览众山小	运动健身	杭州
你看过魔术，但是你玩过魔术吗？近景魔术的表演和学习	派对聚会	杭州
「吉他宝贝」夏末秋实，十节课让你成为弹唱高手	文艺生活	杭州
9月12 相约东白，一起在风车和蓝天下放逐	运动健身	杭州
「红樽坊初级品酒课」唤醒你的嗅觉与味觉，9月体验来袭	派对聚会	杭州
行走在山脊上，龙须山轻装穿越|游友旅行	运动健身	杭州
富阳文村采葡萄?窥探王澍乡土建筑大作	派对聚会	杭州
我要的不是瘦而是线条	运动健身	杭州
9月3日-4日 千岛湖骑行露营皮划艇，湖边烧烤KTV！	派对聚会	杭州
9月5日 龙王山溯溪，把夏日炎炎留在记忆里	派对聚会	杭州
童年的味道，手工牛轧糖	派对聚会	杭州
勇敢者的极限运动，烟霞洞-南高峰岩降初体验	运动健身	杭州
【玩美行摄】3天2晚，美女+美食陪你江浙第一高峰数星星，等日出，玩青瓷	商业	杭州
陶艺：色釉瓷绘，画出最美釉下彩	派对聚会	杭州
9月4日hight玩滑翔伞，带你装逼带你飞	派对聚会	杭州
快乐的画・第五季--平面画板的无限可能	派对聚会	杭州
11-7周六，城市趣玩第3季之特工迷阵	运动健身	杭州
四季如画，江西灵山夹层穿越	运动健身	杭州
「美食+旅行记」早餐女王&tony小王子	派对聚会	杭州
「拉坯」曼妙时光体验，暑期优惠	派对聚会	杭州
一起来做软陶吧！把软萌物带回家	派对聚会	杭州
一花一世界，体验日本花道骷胖美	DIY手作	杭州
手持一把弓 射出射手味 咻咻咻^^	运动健身	杭州
扎染体验 | 蓝印花布，中国传统的一抹蓝	文艺生活	杭州
爱上泥，重回小时候 陶艺体验~	DIY手作	杭州
「假装情侣」七夕单身派对	派对聚会	杭州
9.20周日，桐庐纪龙山探洞，豹子崖穿越！	运动健身	杭州
「拒绝单身」七夕不插电弹唱会，其实这也是一个交友会~	派对聚会	杭州
"女神捉\""腰”记"	运动健身	杭州
「私人定制」亲手穿一串美轮美奂的小叶紫檀佛珠！	派对聚会	杭州
以我之名，冠你指间，黑檀木戒指亲手做	派对聚会	杭州
听路-安静在远方 2015张博全国巡演 --- 杭州站	暂不开放	杭州
云栖赏萤火虫?寻觅牛郎织女星，分享《林间最后的小孩》	派对聚会	杭州
浪漫七夕 |  侣行，我们相约千岛湖！	派对聚会	杭州
天目峡谷玩水避暑，给身体和心灵降个温	派对聚会	杭州
陶艺拉坯，走泥不烧成，弹琴不录音	DIY手作	杭州
垃圾街台球大战，运动美食一起嗨！	运动健身	杭州
要飞咯~~I Believe I Can Fly，8月15一起去永安山滑翔	运动健身	杭州
女人可以没有私房钱，但是不能没有私房照	派对聚会	杭州
迫不及待想知道事业，学业，爱情？！让塔罗师来告诉你	派对聚会	杭州
8月8日大型真人角色扮演游戏 ― 特工迷局	派对聚会	杭州
陶艺――敞口扁浅的盛物器皿，似碟而大	派对聚会	杭州
南高峰，极限速降	运动健身	杭州
静听暮鼓晚钟108响，分享不丹首相大作《幸福是什么》	派对聚会	杭州
还没盲品过？你OUT啦！！	派对聚会	杭州
撒谎可不是好孩子，卡通剧《匹诺曹历险记》	戏剧	杭州
以手绘心，给自己手绘一件T恤，全程有老师指导哟	派对聚会	杭州
同城活动 ｜周五西湖荧光夜跑，我们都是小小的星辰	运动健身	杭州
不平凡的金刚结，静心静气	派对聚会	杭州
「有眼市集×淘在路上」世界等你发现，环球旅行嘉年华杭州站	派对聚会	杭州
带着尤克里里，去只有我们的地方	暂不开放	杭州
一咖啡、一钢琴、一首歌 约吗	暂不开放	杭州
相约小原流插花，让心情早点下班	派对聚会	杭州
塔罗牌阵|心之所愿，洞见未来事件	派对聚会	杭州
想不想露一手”，国家级调酒师教你调酒	酒吧	杭州
一身酒气” 之 叁・行觞” 独立音乐人李志	暂不开放	杭州
湿身大咖”泳池趴，流火夏日，约！约！约！	派对聚会	杭州
神奇的击打乐器「非洲鼓舞」暑期体验课	暂不开放	杭州
周末出宅，夜晚狂欢派对	派对聚会	杭州
「揽胜遍五岳，绝景在三清」三清山绝地走起	运动健身	杭州
10.29浙江唯一一家提供四季滑雪的运动场所，去东北之前来体验一把吧！	户外活动	杭州
「从0到1」台球无极限，新手初体验	运动健身	杭州
李荣浩【老街】：这个古镇还是最初的模样，给你的周末一份温暖	派对聚会	杭州
探幽之江大学茶园林泉 ― 欣赏阿尔罕布拉宫之夜音乐会	暂不开放	杭州
「荷花印香，静候诸君」香篆的学习与演练	派对聚会	杭州
夏日小诗-软陶首饰DIY体验课	派对聚会	杭州
做自己的设计师・改制牛仔	派对聚会	杭州
周日湿身 | 安吉欢乐风暴嬉水王国，最近很火，约吗？	派对聚会	杭州
亲手做的戒指才最有意义	DIY手作	杭州
都市名媛养成记	派对聚会	杭州
致每一个正创业或想创业的你！！	派对聚会	杭州
布艺入门体验--做自己的包包设计师	派对聚会	杭州
静心感受陶器之拙美，陶艺泥塑体验课	派对聚会	杭州
"第二季 | 周末中午啪,啪,啪”，体验时下最潮的剑道魅力！"	运动健身	杭州
巴西战舞：林志玲的塑身利器	运动健身	杭州
面朝大海，沙滩露营，骑行美丽海岸线！	派对聚会	杭州
爱情，事业，学业？！让塔罗师来告诉你	派对聚会	杭州
清凉小生活――粘土手作	派对聚会	杭州
溯溪徒步|井空里，巨石上的芭蕾	运动健身	杭州
”天湖泛彩、蚁舟夕照、少滩奇纹、南国天山	运动健身	杭州
越缓慢越治愈――修一座爆红世界朋友圈的秘密花园	派对聚会	杭州
扎营檀头山，享受海鲜大餐，蓝天阳光和沙滩	派对聚会	杭州
美女领队带你玩转五泄秀丽山水	派对聚会	杭州
【武举考试】射箭科目，等你来战！	运动健身	杭州
碧海蓝天，私奔东极岛	派对聚会	杭州
最浪漫的避暑方法：去葡萄酒酒庄来场邂逅	派对聚会	杭州
两天一夜 | 面朝大海，露营在无人荒岛竹屿岛”，传说中的中国济州岛!	派对聚会	杭州
high玩滑翔伞，带你装逼带你飞	派对聚会	杭州
有胆你就来！华东第一险漂--勇闯将军关漂流「预定即送手机防水袋」	派对聚会	杭州
江南第一关「徽杭古道」户外驴友初级线路	运动健身	杭州
大溪峡激流闯滩漂流，环溪古村看荷花	派对聚会	杭州
两天一夜 | 苏州乐园音乐啤酒节，狂欢心跳与美食之旅	派对聚会	杭州
指尖上的艺术――粘土手作	派对聚会	杭州
咖啡里的零基础美术体验――手绘纨扇活动之二?	派对聚会	杭州
檀头岛，看日出玩篝火，听海哭的声音	运动健身	杭州
「仅限十人」准备好你的肾上腺素，来一场怨灵屋之旅	派对聚会	杭州
超值体验|零基础非洲舞公开课	运动健身	杭州
两天一夜 | 黄山桃花源漂流，玩转西递，高逼格住宿	派对聚会	杭州
"第二弹 | 周末中午啪,啪,啪”，体验时下最潮的剑道魅力！"	运动健身	杭州
开心就要飞起来~杭州富阳永安山滑翔基地	派对聚会	杭州
不识庐山真面目，只缘身在此山中，庐山探秘两日行	运动健身	杭州
括苍山扎营，一起看星星看云海	运动健身	杭州
「私人影院」电影只看我喜欢	电影	杭州
花开春暖 | 骑马射箭玩草泥马，阳山畈看漫山桃花	户外活动	杭州
陶艺DIY：在城市森林里玩个泥巴	派对聚会	杭州
两天一夜 |  露营在沙滩上，骑行在中国最美海岸线!	户外活动	杭州
国庆短线 | 10.4-10.6 一路向南，大声说出你的爱，中国十大最美岛屿大嵛山岛”	户外活动	杭州
【挖财告诉你】存钱太慢花钱太多的你，到底需要什么？	派对聚会	杭州
徒步莫干山，重走蒋公道	派对聚会	杭州
请你写一首词，我为你谱一首曲	暂不开放	杭州
走你的徽杭古道	派对聚会	杭州
父亲节做一个惊喜给那个男人（手工皮具DIY体验）	派对聚会	杭州
嗨翻天的潮相声每周一场	暂不开放	杭州
小原流插花体验课--据说精致生活的人都爱它	派对聚会	杭州
端午特辑 | 薰衣草花海，198米垂直落差漂流，约吗？	派对聚会	杭州
两天一夜 | 吹着海风，喝着啤酒，光着脚丫在沙滩	派对聚会	杭州
南沙露营欧冠狂欢	派对聚会	杭州
来自星星的梦幻油画课	派对聚会	杭州
「9.9抢票」一起去万象城帅气地滑冰	运动健身	杭州
奔跑吧！否则名牌就被撕掉了	派对聚会	杭州
两天一夜 | 檀头山岛，捉螃蟹捡贝壳，篝火露营沙滩praty！	派对聚会	杭州
去离家最近的薰衣草庄园，拍美照，吃烧烤，喝啤酒，撕名牌	派对聚会	杭州
一曲笛音长相守 ，一舞情深长相思	文艺生活	杭州
清明特辑 | 别样千岛，环湖骑行皮划艇，湖边烧烤五星级露营	户外活动	杭州
带着尤克里里，去那个只有我们的地方	暂不开放	杭州
法式下午茶，将浪漫进行到底	DIY手作	杭州
"「零基础油画」夏日炎炎,许你一池清莲"	派对聚会	杭州
塘栖古镇拍创意，塘栖枇杷吃到饱	派对聚会	杭州
时间就是要浪费在美好的事情上 ――手绘纨扇活动	派对聚会	杭州
西施故里吃豆腐，诸暨五泄奇幻漂流	派对聚会	杭州
周四特惠攀岩，你还能再更帅一点吗	运动健身	杭州
遂昌桃源尖，醉卧花丛	运动健身	杭州
「母亲节特惠」亲手画画送妈妈	派对聚会	杭州
关于「射箭」，还能再性感一点吗	运动健身	杭州
美莲花房Diy活动―苔藓星球	派对聚会	杭州
体验一把高尔夫，我们来了	运动健身	杭州
两天一夜 | 别样千岛，环湖骑行皮划艇，湖边烧烤露营！	派对聚会	杭州
跟随爱丽丝去「梦游仙境」	戏剧	杭州
非洲鼓：好玩停不下来	暂不开放	杭州
没事笑一个，快来听相声	戏剧	杭州
荻浦花海拍大片，桐洲岛上慢生活	派对聚会	杭州
一起去万象城帅气地滑冰吧！	运动健身	杭州
舟山露营大会 大声说你想跟我去看海	派对聚会	杭州
吹着海风，喝着啤酒，光着脚丫在沙滩	派对聚会	杭州
塔罗占卜：预见你的未来	派对聚会	杭州
插花体验课：小原流―花艺匠立式	派对聚会	杭州
学会化妆，遇见更美的自己	派对聚会	杭州
「禁忌」的密室・试图逃脱的你	派对聚会	杭州
私人电影院：只看你想看的~	电影	杭州
「懒人生活指南」一元享受专业推拿，甩掉亚健康	派对聚会	杭州
手作| 陶泥里的慢时光	派对聚会	杭州
「花港观鱼」牡丹、紫藤、绣球花摄影	派对聚会	杭州
穿越徽开最美古道，徒步白际原始村落	运动健身	杭州
尝一口「彩虹」的味道	DIY手作	杭州
「懒人生活指南」美味小龙虾―让舌尖带你去旅行	DIY手作	杭州
错过就会后悔的「皮影戏」	戏剧	杭州
花开吴越，陪你去看樱花雨	运动健身	杭州
1元体验滑冰，现场看场冰球比赛	运动健身	杭州
1分钱体验萌萌的私人影院	电影	杭州
赏家朋油菜花海，徒步家荆古道	运动健身	杭州
密室悬念重重，一定带好队友	派对聚会	杭州
一起文艺地玩「泥」	派对聚会	杭州
当个手艺人，做自己的紫砂器	派对聚会	杭州
刺激开战-室内真人CS邀你来释放压力！	运动健身	杭州
开心时刻，悠享家	DIY手作	杭州
微景观制作：把春天留在宝盒里	派对聚会	杭州
让小鱼亲吻你的脚丫	派对聚会	杭州
妈妈们的福利来啦！1元体验周末卡乐彩儿童乐园	派对聚会	杭州
美貌的杯子蛋糕，你也可以做出来	DIY手作	杭州
想在电影院躺着看电影？	电影	杭州
生活已如此艰难，周末不如对自己好一点	派对聚会	杭州
不是一个人的周末才是周末，春暖花开一起来爬南高峰	运动健身	杭州
让孩子来「淘气」一下吧	派对聚会	杭州
白色情人节亲手做一盒蛋糕给爱的人	DIY手作	杭州
来射箭吧―耐力和力量的考验	运动健身	杭州
白色情人节亲手做件陶器送给Ta吧	派对聚会	杭州
情人节的午后来这里坐坐	DIY手作	杭州
白色情人节巨幕观影《灰姑娘》	电影	杭州
白色情人节「好厨师」上门为您做大餐	DIY手作	杭州
告别新春，让我们运动起来	运动健身	杭州
定制你的爱-想去手工课堂	派对聚会	杭州
亲手DIY一盆多肉送给Ta	派对聚会	杭州
用粘土做个精美的摆件吧	派对聚会	杭州
喝一杯啤酒听一曲民谣	酒吧	杭州
带上宝宝来场职业体验吧	派对聚会	杭州
嘿，可以请你吃火锅吗？	DIY手作	杭州
来海洋村探寻海洋世界吧	派对聚会	杭州
一起来「喜悦」的滑冰吧！！	运动健身	杭州
「重磅福利」首家韩式美容火锅登陆杭城	DIY手作	杭州
「游侠客风筝音乐节」我说yes，你说闹，音乐不要停，风筝放起来！	派对聚会	杭州
「灵峰探梅」人像摄影外拍	派对聚会	杭州
游侠三路大军会师灵峰，探梅觅芳踪	派对聚会	杭州
Love Party！双人精品套餐免费送	派对聚会	杭州
肚皮舞体验课堂	运动健身	杭州
跆拳道课程体验	运动健身	杭州
挑战自我，一起来攀岩！	运动健身	杭州
一起来建一座「乐高城市」吧！	派对聚会	杭州
每个宝贝都是小天才	派对聚会	杭州
9.9元看电影！9家影城任你选！	电影	杭州
桌球体验，让你感受不一样的风度	运动健身	杭州
快来体验一把弓箭手的感觉	运动健身	杭州
来中国首家休闲MALL玩个痛快	派对聚会	杭州
瑜伽大师|感受身体在呼吸	派对聚会	杭州
3D魔幻错觉艺术馆	派对聚会	杭州
黄龙洞宝石山定向登山	运动健身	杭州
赏梅寻宝撕名牌大战	运动健身	杭州
带上宝宝来制作「粘土」版马卡龙	派对聚会	杭州
情人节亲手做件陶器送给Ta吧	派对聚会	杭州
喝一口暖心鸡尾酒	酒吧	杭州
其实我不是蘑菇，我是个来自外太空的 包子”	DIY手作	杭州
「懒人专属」免费火锅送上门	DIY手作	杭州
私人影院―专属的浪漫周末	电影	杭州
「周末特惠」来MOMODA和海狸先生做游戏吧	派对聚会	杭州
一起来嗨皮吧，你想玩的，我们都有	派对聚会	杭州
「懒人专属」找个五星级酒店的大厨上门烹调美食	DIY手作	杭州
「周末特惠」来一起品尝一下巧克力火锅吧	DIY手作	杭州
草莓正当时―采起来	派对聚会	杭州
你能解开这「无尽之迷」吗？	派对聚会	杭州
「周末特惠」耐力和力量的考验―来射箭吧	运动健身	杭州
「元旦特惠」2015年的第一天去看场电影吧	电影	杭州
和喵星人一起品尝手工原味奶酪	DIY手作	杭州
「身」在杭州「心」在首尔	DIY手作	杭州
多肉组合盆栽DIY	派对聚会	杭州
2014的最后一天看场电影吧	电影	杭州
「周末特价」妈妈们的福利来啦！1元体验周末卡乐彩儿童乐园	派对聚会	杭州
「周末特价」体验冰上圣诞季―滑冰加驯鹿彩绘	运动健身	杭州
遇见对味的你--圣诞单身Party	派对聚会	杭州
现实主义荒诞派喜剧「驴得水」	戏剧	杭州
「圣诞亮灯仪式」一起来点灯吧！	酒吧	杭州
杭城首届密室逃脱大赛--Xcape赛场	派对聚会	杭州
慢艺术零基础DIY油画	体验课	合肥
伤逝乐队 15 周年巡演 合肥站	暂不开放	合肥
海象先生骨肉皮”全国巡演 2015 Britpop之夜―呼和浩特站	暂不开放	呼和浩特
Hey ！要不要一起飞？	户外活动	惠州
世界名曲轻松上手   成就你的钢琴梦想	文艺生活	济南
优雅运动99元挥杆特惠之旅	运动健身	济南
茶空儿聚会――我们一起炒龙井茶吧	茶会雅集	济南
日本里千家茶道研修班 | 在朴素无华的事物中，发现纤细且简朴的美	茶会雅集	昆明
亲手制作天然又美貌的手工皂，温柔呵护肌肤	DIY手作	昆明
uber终于来了， 我再也不用哭着说：昆明只能用滴滴！	户外活动	昆明
我要静静地练拉坯	DIY手作	昆明
蘑菇市集・流浪指南	派对聚会	昆明
甜甜蜜蜜下午茶  我们的美味手帐	文艺生活	昆明
时髦的生活者与优雅的写作者--弗雷德里克?西里耶	讲座沙龙	昆明
［塔罗教室］2016年全年运势预测服务	派对聚会	昆明
周末草月流花道分享体验：拈花而笑，岁月静好	体验课	昆明
艺式苑小画班&活泥巴 活动课开始报名啦！	体验课	昆明
我在抱愎し浚我在亲手做一把只属于自己的紫砂壶！	DIY	廊坊
夏日・做一件只属于自己的紫砂陶器，赴一场匠人之约～	派对聚会	廊坊
光棍节约你----丽江艳遇-梅里雪山--虎跳峡--泸沽湖7天	户外活动	丽江
古琴集训班	文艺生活	洛阳
您好，请去掉您图片上的水印，谢谢。指尖上的艺术――沙画体验	体验课	南昌
初级茶艺课，年份普洱品鉴 | 细品茶滋味	茶会雅集	南京
零基础油画课程	DIY手作	南京
【中蕴?笔墨春秋】成人书法国画”减压课程	文艺生活	南京
第十二届中国南京农业嘉年华 | 新鲜健康的有机蔬果，去看看他们是怎样种植的吧？	户外活动	南京
左琴右书”中式书斋文化体验课	文艺生活	南京
弯弓射箭，行走天涯	运动健身	南京
至不会化妆的你――美妆课程	DIY手作	南京
追艺之路 |一画方寸地，悠然汝自得	文艺生活	南京
大师教你学钢琴， 快速晋级钢琴大咖	文艺生活	南京
SideTours  静生活之道――茶道 | 沐心养生，偷得浮生一日闲。	茶会雅集	南京
周五晚7点  尤加利手作课 | 让素静的尤加利突然焕发生机	DIY手作	南京
浪漫七夕，中国传统风俗游园会	派对聚会	南京
尤克里里音乐晚会	暂不开放	南京
成人古筝速成教学  与古筝只有有个约会	文艺生活	南京
仅需158元  世界名曲轻松上手， 成就你的钢琴梦想	文艺生活	南京
脑洞大开 颠覆你的ppt	沙龙学堂	南京
银泥创意，手作你的珍爱之选	DIY手作	南京
57秒揭开生命的密码	沙龙学堂	南京
萌萌哒动物饼干DIY | 美味的点心和友好的氛围来温暖你	DIY手作	南京
植鞣卡包DIY―手工皮具课程	DIY手作	南京
流行钢琴弹唱速成教学 错过少年！错过青年！抓住现在！	文艺生活	南京
百步穿杨的力量---单人射箭体验	运动健身	南京
外教教你如何战胜强壮对手-巴西柔术体验课	运动健身	南京
Dreamon最萌组合带你走进定制音乐现场	文艺生活	南京
趣味攀岩赛――岩壁上的猴腮雷！	运动健身	南京
茗一壶清茶，在悠闲的时光里慢慢学习古琴	文艺生活	南京
第一节课就可以自弹自唱流行歌曲！就这么快！	文艺生活	南京
人莫言，琴自语。古琴零基础成人精品小班课	文艺生活	南京
【撕名牌交友】――地铁名牌任你撕！	运动健身	南京
话剧《茶馆》--感受清末民初中国社会的变迁	戏剧	南京
安徽家朋徒步招募令	户外活动	南京
优雅高尔夫99元超值套餐！赠球杆+手套+30分钟教学指导+100颗击球	运动健身	南京
婚纱初体验，只为最美的你嫁个最爱的他	体验课	南京
【DIY手绘】小猴子俄罗斯套娃，猴年吉祥萌物	体验课	南京
南京 小课咖啡 亲手做咖啡	DIY	南京
零基础入门楷书或隶书｜滴水研墨，执笔挥毫，等你书写一页情怀	文艺生活	南京
古筝体验|遇见最美的弦声，缓缓体验古筝之音	文艺生活	南京
神秘塔罗牌之旅	沙龙学堂	南京
跟着美腻汪老师，速成尤克里里	文艺生活	南京
『每个小王子都有一座小星球』手工牛皮铃铛DIY	DIY手作	南京
[一起来做耍刀客]玩转橡皮章	派对聚会	南京
江宁黄龙岘写生茶会	派对聚会	南京
来一场说走就走的旅行！吴越古道徒步	运动健身	南京
[想与你画一张专属于我们的永恒]七夕主题油画	派对聚会	南京
我的T恤我做主 ― 夏日彩绘T恤	派对聚会	南京
成人基础手绘教程开课啦	派对聚会	南京
走出一座填色的花园，色彩画里有另一个世界~颐和路民国建筑里的【绘画艺术沙龙】	派对聚会	南京
一个人读书是孤独的旅程，一起读书是领略彼此风景	派对聚会	南京
奇妙的味蕾之旅，美食美课超值体验	DIY手作	南京
现代生活必不可少的实用防身术	运动健身	南京
从妓妾到一代画魂 ・ 油彩中飘散出来的女人 潘玉良	派对聚会	南京
南京首场露天室外漫展 ― 夏夜祭袭来！	派对聚会	南京
神道梦想流--和我们一起感受杖道的魅力吧	运动健身	南京
夏日「零基础」自助油画DIY体验	派对聚会	南京
做个手艺人 ・ 牛皮包DIY	派对聚会	南京
卡哇伊饼干DIY体验	DIY手作	南京
融化在指尖上的香甜 ・ 杯子蛋糕创意裱花	派对聚会	南京
一支铅笔一块橡皮创造的美丽，去体验黑白装饰画课吧	派对聚会	南京
时尚时尚最时尚 ・ 蔷薇园里画个美美的帆布袋	派对聚会	南京
我是不是很帅很可爱 ・ 打豆豆猫咪主题咖啡馆	派对聚会	南京
有眼市集<Mroe in Party	派对聚会	宁波
杉田音乐社，一起学吉他、尤克里里、钢琴、架子鼓	文艺生活	宁波
世界名曲轻松上手，  成就你的钢琴梦想	文艺生活	宁波
日本煎茶道体验班	茶会雅集	宁波
来创作一只属于自己的装饰熊	DIY	宁波
Ours外语社法语试听课	派对聚会	宁波
Ours外语社日语试听课	派对聚会	宁波
Ours舞蹈社开课啦~	运动健身	宁波
武功山穿越 | 观日景如金在冶，游人履步彩云间。	户外活动	萍乡
沃尔得携手万象城「透明直播间 Voice Lab」，给你不一样的英语学习体验！	沙龙学堂	青岛
在人际关系里成长――冥想主题沙龙	沙龙学堂	青岛
Six nightmares of Odin	暂不开放	青岛
简单有趣的极限运动―浮山岩壁速降	户外活动	青岛
「Lovi艺术画室」您的专属绘画空间	文艺生活	青岛
Interestingbook《早已没耐心听你的诉说》全国巡演 青岛站	暂不开放	青岛
【北漂团伙】解压Party-重音枕头大战	暂不开放	青岛
沃尔得明星外教周末班三节课！口语/商务/出国/零基础任选	沙龙学堂	青岛
花粥-驳倒《不信你去打听打听》全国巡演 青岛站	暂不开放	青岛
海上夜景晚餐，创造属于自己的美好回忆	户外活动	青岛
新声浪一周年纪念专场演出 青岛站	暂不开放	青岛
中国第一位女沙画大师邀你体验沙画的流动艺术	文艺生活	青岛
DO HITS PRESENTS: MOTHERLAND 华人制作人的回游之旅	小型现场livehouse	青岛
苏晴《常想一二》全国巡回音乐会	小型现场livehouse	青岛
海龟先生2016最佳拍档”全国巡演 青岛站 DOWNTOWN－BAR	小型现场livehouse	青岛
16年摇组第一趴――[醒春]炸裂出世	小型现场livehouse	青岛
黑子沛新专辑《老同学》全国巡演 青岛站 DOWNTOWN－BAR	小型现场livehouse	青岛
12.25三校联合大趴	小型现场livehouse	青岛
迷音 ［白色爵士］青岛站 DOWNTOWN－BAR	小型现场livehouse	青岛
HIPHOP LIVE VOL.1	小型现场livehouse	青岛
诱导社乐队被捆绑的灵魂2015年秋季巡演 青岛站 DOWNTOWN－BAR	小型现场livehouse	青岛
2015丢火车乐队全国巡演 青岛站 DOWNTOWN－BAR	小型现场livehouse	青岛
日本另类摇滚乐团THE ANDS 2015中国巡演 青岛站	小型现场livehouse	青岛
我想遇见更好的自己 | 一对一心理咨询	派对聚会	青岛
[你收到一份鬼魅的万圣节请柬]	DIY手作	青岛
加拿大创作男歌手Matthew Barber 青岛DOWNTOWN－BAR 专场演出	暂不开放	青岛
轻松缓解你的烦恼	派对聚会	青岛
去DOWNTOWN－BAR听「郑小辫」唱歌	暂不开放	青岛
一起画美美的星云	派对聚会	青岛
致匠心，陶艺里的慢时光 | Color Me Pottery创意陶瓷	派对聚会	青岛
「约吧 my love」私人影院轰趴馆	派对聚会	青岛
岁月知味.蒋明与空山乐队2015夏季巡演―青岛站	暂不开放	青岛
想要飞檐走壁？那就来攀岩吧！	运动健身	青岛
靠谱先生WALKER全国巡演-青岛站	暂不开放	青岛
特惠抢购 | 外教精讲TED Talk 「A 30-year history of the future」	派对聚会	青岛
沃尔得国际英语【暑期一个月外教课程】，短而有料！	派对聚会	青岛
逃避了今天，你失去了明天	沙龙学堂	青岛
在潜意识中遇见，直觉卡（OH）沙龙	派对聚会	青岛
摇趴续摊	暂不开放	青岛
DOWNTOWN & FOOTPRINT Sessions with NiChiFanLeMei LIVE 中国巡演	暂不开放	青岛
【国庆】  深入黔东南 ・ 跟随贝尔探秘原始森林 ・ 体味蚩尤后人多彩少数民族风俗！	户外活动	全国
轻松乐活，手冲咖啡体验课	文艺生活	厦门
（零基础学习）你与G神距离，只差2小时妆点素颜	沙龙学堂	厦门
法语零基础入门试听课 | 走近世界上最美的语言	沙龙学堂	厦门
击剑体验 | 格斗中的芭蕾，做一回优雅骑士一剑决胜负	运动健身	厦门
【交友】绘画/音乐/电影/咖啡/跳棋 | 这是一座有温度的城市	派对聚会	厦门
【永定土楼 提前预订节省59元一张】纯玩一日游 大鱼海棠 高北土楼群	户外活动	厦门
复古口金零钱包 拥有它，做个优雅的小女人	DIY手作	厦门
【晨曦画室】生活有点斑斓，更精彩~	文艺生活	厦门
这个夏天，你可以没有男朋友，但不能没有写真	文艺生活	厦门
【海洋运动.皮划艇体验】无需游泳可参加 专业教练带队皮划艇、桨板	户外活动	厦门
海上帆船 | 想体验躺在海里惊叫连连的刺激吗？有机会遇见白海豚哦~	户外活动	厦门
NLP心理沙龙|做回自己”是种怎样的体验？	沙龙学堂	厦门
厦门五缘湾帆船体验	户外活动	厦门
鼓浪屿五大景点联票 | 最文艺的鼓浪屿，最温柔的厦门	户外活动	厦门
制陶，绽开在指尖上的艺术	DIY手作	厦门
沙坡尾 手作?美食 创意生活营 |复古口金零钱包 拥有它，做个优雅的小女人	DIY手作	厦门
出走一夏去乘凉，厦门海边水球趴	派对聚会	厦门
古筝体验|超低课时费 一对一只要62.5一节	文艺生活	厦门
城市活动|Dream Catcher 印第安捕梦网-捕住美梦与好心情	DIY手作	厦门
帆船体验|扬起风帆，带你远航	户外活动	厦门
手作的魅力 一对一陶艺私人定制	DIY手作	厦门
优雅运动99元高尔夫挥杆之旅	运动健身	厦门
冰雪体验+帆船体验	户外活动	厦门
绘画课，打开另一个世界	文艺生活	厦门
凌波香榭・成人写意国画体验课	文艺生活	厦门
零基础成人流行音乐教学体验试听课――打造属于自己的歌声	文艺生活	厦门
美食DIY|cupcake＆焦糖饼干	DIY手作	厦门
琉璃韶华 时光有处可栖	DIY	厦门
最美私游・踏青洗肺茶之旅	茶会雅集	厦门
芬芳四月：一束插花，一篮春天	派对聚会	厦门
城市轻旅行|天台，撸串，啤酒，电影	派对聚会	厦门
陶艺生活，泥土的艺术	DIY	厦门
拯救你的五音不全，从此做麦霸！！！	文艺生活	厦门
用创意击败梅雨，3月27日春厦集市”燥起来~	展览	厦门
形体塑造，锻炼柔韧---珠玛瑜伽	运动健身	厦门
79元，2次课  学4首钢琴曲 | 体验一次快乐的钢琴之旅！	文艺生活	厦门
身形剧本――三影堂摄影艺术中心原作收藏展	展览	厦门
来拍照吧 在这个近海的城市	户外活动	厦门
专属于你的纯银饰品｜大芬纯银DIY体验	派对聚会	厦门
带您体验指尖上的沙画艺术	文艺生活	厦门
The Tree 主题艺术作品联展	展览	厦门
有眼市集SHANGHAI<自由吧寒假	市集	上海
【周末】栲栳山古道徒步，探寻浙东千年古镇的旧时光（1天）	户外活动	上海
秋冬季田子坊创意调酒大师体验班	DIY手作	上海
手帐女王的速成大法 | 绘制自己的生活回忆录~~	文艺生活	上海
11.18-20 徒步最美古道秋色黄南古道+琼台仙台	户外活动	上海
与外国留学生一起参加光棍节派对	派对聚会	上海
【周末】婺源篁岭晒秋，石城古枫迷雾，红枫古道梦幻秋色	户外活动	上海
日本奇幻动漫游学之旅 | 【名侦探柯南】会告诉你真相只有一个！”	户外活动	上海
2016光棍节大型活动 神棍大挑战主题派对 | 这个双十一，不剁手，不虐狗	派对聚会	上海
莫干山登山徒步摄影 | 天然大氧吧，难得的洗肺之所	户外活动	上海
一场冥想的性感|新西兰美酒品鉴 +瑜伽冥想+DIY热红酒	文艺生活	上海
单身徒步Walk shanghai----漫步法租界	户外活动	上海
大雅美学 | 玩转手冲咖啡课堂	文艺生活	上海
用OH卡来探索自我 | 一套神奇图卡打开内在世界的大门	沙龙学堂	上海
心期三读书会―《画的秘密》打开你心里的秘密	文艺生活	上海
女神的舞蹈丨大咖舞蹈鉴赏party	派对聚会	上海
【周末】相约人间仙境神仙居，探访仙人居住的地	户外活动	上海
体验课 | 金工雕蜡――本王来收割一下你们的膝盖	DIY手作	上海
（空心特价）11月4-6日：婺源五岭古道，篁岭晒秋之旅	户外活动	上海
11月06日： 登世纪冰川遗址---覆卮山轻装徒步活动	户外活动	上海
10月16日 小鉴人” 专业鉴赏课程 全新开始 深入学习收藏投资	沙龙学堂	上海
万圣节花艺布置课程-零基础-万圣节南瓜头DIY	DIY手作	上海
10.30周日丨上海去阳澄湖莲花岛徒步吃蟹	户外活动	上海
皮具DIY|在老洋房里探索皮具的温暖	DIY手作	上海
万圣节丛林狂欢派对@ Gene's Way	派对聚会	上海
10月30日：乌龙古道+品味农家美食	户外活动	上海
你有画过彩沙画吗？	DIY手作	上海
相约吴越古道：走千年古道，看壮美天池，探幽深峡谷	户外活动	上海
匠心之旅―经典长款钱包/手拿包，零基础也能学会的手作	DIY手作	上海
【秋游季】穿越华东香格里拉―仙居公盂古村落看梯田	户外活动	上海
尤克里里入门课程（送尤克里里）| 来自夏威夷的风情小吉他	文艺生活	上海
定制你的魅惑红唇 | 风情万种的口红DIY	DIY手作	上海
以书会友 《老庄》读书会 ・ 思维碰撞 相互学习 共同成长	文艺生活	上海
全面释放少女心  超萌的刺绣课程	DIY手作	上海
【一起画】老洋房里的双人绘！	文艺生活	上海
【周末】徒步最美秋景南黄古道，探访隋朝古刹国清寺（2天）	户外活动	上海
10月16日旅行分享｜日本情报局，听一听在日本的有趣故事。	文艺生活	上海
10.15 体验高空遨游的感觉；感受滑翔伞带来的惊喜刺激！	户外活动	上海
【城市猎人吃货召集】10.15铜川路海鲜寻宝定向	户外活动	上海
老洋房里学色彩 | 零基础成人水彩风景画	文艺生活	上海
游木n堂10月15日 | 第六：:玩哼[蜃R木材，免M送木器。	沙龙学堂	上海
【书法课10月23日】能死鲜教授国之风雅	沙龙学堂	上海
1对1形象打造|私人形象顾问贴身服务	沙龙学堂	上海
探索大闸蟹发源地，莲花岛徒步穿越品蟹（1天活动）	户外活动	上海
送你把尤克里里随性弹	文艺生活	上海
【12月03-04日】相约枸杞岛----离我们最近的碧海蓝天	户外活动	上海
10月30日：最美风车公路徒步之旅	户外活动	上海
美食油画-是值得你浪费的时光	DIY手作	上海
上海陈正雷太极学院--正宗陈氏太极六手四象功课程	运动健身	上海
万圣节？抓紧一切机会美美美才是正经事	DIY手作	上海
老洋房动手来做私房菜”，get约会最重要的技巧	派对聚会	上海
可远观可亵玩：做一个日系风陶艺	DIY手作	上海
11月20日：横沙岛――骑行在海岸线	户外活动	上海
【DIY-漫生活】纯天然口红 DIY	DIY手作	上海
圆通古寺禅修体验之旅 | 体察身心、开阔心胸、净化心灵	户外活动	上海
零基础彩铅 | 执一支画笔体验每个周末的艺术生活	DIY手作	上海
探寻原生态衢山岛，阳光沙滩，蔚蓝大海2日活动	户外活动	上海
"【周末】探索霞幕山古道：体验传说中的\""山水胜绝之所\"""	户外活动	上海
上海迎【国庆】化妆试纱会 | 想提前看看你做新娘子时的美丽模样吗？10月1―3日	沙龙学堂	上海
徒步吴越古道，漫步浙西天池	户外活动	上海
aMaze真人密室逃脱，等待你的挑战《罪恶之心》	派对聚会	上海
社群下午茶----自媒体如何玩社群	沙龙学堂	上海
夏威夷呼啦舞蹈初级	运动健身	上海
"9月30日-10月7日（国庆连续3期）东极岛-看中国第一缕曙光,后会无期"	户外活动	上海
最美不过工笔画 | 丹青写出与君看（三馆通用）	DIY手作	上海
探寻太湖中的隐秘小岛：东山岛环岛徒步，看湖光山色，太湖菜	户外活动	上海
彩铅 零基础绘画 你的美好小事	DIY手作	上海
THE ONE VR娱乐电竞馆 | 感受虚拟世界的变化	派对聚会	上海
精确本身就是一种奢华――维欧腕表知识分享会	沙龙学堂	上海
精油DIY体验大优惠――芳疗师指导你调制属于自己的精油	DIY手作	上海
【国庆】徒步即将消逝的村庄：仙居公盂（10/5-6）	户外活动	上海
以錾刻技法来制作一片秋日的银杏叶，别在你秋日的毛衣上	DIY手作	上海
探秘美丽的枸杞岛：出海捕鱼、沙滩海鲜、日出日落	户外活动	上海
10月22-23日：行走水牛背，穿越千丈幽谷	户外活动	上海
【行业交流】头脑风暴沙龙	沙龙学堂	上海
《致命游戏》户外角色扮演撕名牌点爆你的逻辑和体力！	派对聚会	上海
旅行分享｜青海的正确打开方式	沙龙学堂	上海
9.15中秋节”【莫干山】古道人文―单天徒步穿越国家级登山步道	户外活动	上海
横沙岛欢乐骑行・看大海・抓螃蟹・采水果・农家菜1天活动	户外活动	上海
9/22-知觉【说说】| 人际关系中的那点事儿~	沙龙学堂	上海
选择恐惧症和好奇宝宝的超级福利~~288元任选3种体验课	文艺生活	上海
弦清乐府  卡洪鼓体验课（一节课学会情非得已的节奏）	文艺生活	上海
檀头山岛搭帐篷，看日出，沙滩散步，在篝火边数星星~	户外活动	上海
走进华东仙境--仙居公盂	户外活动	上海
【 每周六、日】 时装画｜都市恋生活，绘制都市生活的美好状态	文艺生活	上海
【走最经典驴行线路-上海出发】历史的邂逅，你最想走的古道 漫步徽杭古道	户外活动	上海
一起做手机壳吧~你的手机那么美，给它换一件衣裳吧~	DIY手作	上海
【去崇明岛放空】采水果・农家菜・看最美西沙湿地芦苇荡・逗螃蟹1日活动	户外活动	上海
抉择－异能训练基地	派对聚会	上海
大宁灵石公园旁学摄影 | 学几个专业的摄影tips，照片红遍朋友圈~~	文艺生活	上海
【形象管理】一只口红！就能满足你对所有风格妆面的想象！	沙龙学堂	上海
第3个周六丨去上海最近的海岛徒步	户外活动	上海
咖啡馆馆主的一天 | 不要一直宅在家里，给自己的生活加点颜色吧	文艺生活	上海
新年看日出 在东极遇见最美的自己，谱写你心中的后会无期”	户外活动	上海
【周末】去覆厄山，登秀美山峰，赏千亩梯田，触冰川遗迹，访火山岩柱	户外活动	上海
妙天Hi世界 | 零距离接触最新、最快、最时尚的科技体感，带给你美妙的一天！	派对聚会	上海
珠宝金工体验-----做一款你爱的素戒	DIY手作	上海
九月来红樽坊学品酒	沙龙学堂	上海
一节课学会一个吉他小曲子	文艺生活	上海
即兴剧新玩法――即兴音乐盒	派对聚会	上海
S共读会――《爱的进化论》	派对聚会	上海
给最重要的人亲手做份月饼 | 月饼还是自己做，吃着更开心	DIY手作	上海
aMaze真人密室逃脱，等待你的挑战《特工007》	派对聚会	上海
8月27日：黑龙潭溯溪徒步一日活动	户外活动	上海
淳品咖啡馆杯测分享会活动	文艺生活	上海
9/8-知觉【说说】就职两难：生存面包or精神苹果	沙龙学堂	上海
欺诈游戏 | 当电影成为现实，到底是惊喜？还是惊悚刺激？	派对聚会	上海
【DIY-健康厨房】DIY两份美味，中秋送礼体面过人	DIY手作	上海
【避暑】万米高空栈道，千米清凉隧道，万丈峡谷瀑布，一起探幽大明山！	户外活动	上海
给自己设计珠宝 零基础的你也可以的！性价比之高，超出你相象！	沙龙学堂	上海
水弹枪大战	户外活动	上海
有车一族必备技能学习课堂【超实用】	派对聚会	上海
拿起画笔 | 完成你今夏未做完的梦	文艺生活	上海
给孩子财富，不如把孩子变成财富----梧桐亲子财商俱乐部开班啦~	沙龙学堂	上海
玩什么不好，玩艺术？尽在鹦鹉螺任性文创嘉年华	派对聚会	上海
约上最好的闺蜜，享用一场浪漫的下午茶，还有猫咪的温柔陪伴	派对聚会	上海
【D7Dance】K-Pop韩国流行舞 精品小班课	运动健身	上海
《 被讨厌的勇气》共读会	文艺生活	上海
温暖下午茶 | 与朋友相约，喝一杯咖啡，小憩一下~~~	派对聚会	上海
3000年等待换一次相逢，如今有琴等你（三馆通用）	沙龙学堂	上海
如何让你的手机壳高逼格？魔都七夕礼物花艺DIY手机壳	DIY手作	上海
10月15日：上青古道一日徒步活动	户外活动	上海
8月7日在老上海的别墅里  学习魔幻钢琴课程  一节课就能弹爱的罗曼史	文艺生活	上海
纸杯蛋糕特惠【两付一】，开约！	DIY手作	上海
用一天的时间认识民艺（五）| 把山洞里的造纸术带进生活	DIY手作	上海
喵星人下午茶 | 一壶茶，三两好友，让喵咪陪伴你午后的时光！	派对聚会	上海
LesAirs大悦城店七夕DIY饰品”	DIY手作	上海
【周末】避暑：入茫茫竹海，享夏日清幽，登巍巍王位山（1天）	户外活动	上海
【青年零基础钢琴入门】学会一个文艺的新技能才是正经事儿	文艺生活	上海
给你的男神制作一款牛皮短夹吧！	DIY手作	上海
制作一块独一无二的实木砧板	DIY手作	上海
给自己半天时间，学习自我管理！	沙龙学堂	上海
手工皮具小物件|卡套／卡包／钥匙包／零钱包／驾照包皆可	DIY手作	上海
染出你的风情万种｜云南扎染体验	DIY手作	上海
【摄影活动】探秘直升机，还有比基尼美女相伴	户外活动	上海
【品酒×避暑】红樽坊八月初级品酒课	沙龙学堂	上海
当彩泥遇见油画-半立体彩泥油画体验	DIY手作	上海
边际旅行  静生活之道――插花	茶会雅集	上海
读书会丨《一个人的朝圣》，蕾秋・乔伊斯（英）著	文艺生活	上海
我的箱子会唱歌 | 最in的Cajon等你来激活	文艺生活	上海
中日韩交友会（每周六下午）（无语言与国际限制）	派对聚会	上海
女神变身记 │ELZA带你找到适合的穿衣风格！	沙龙学堂	上海
指尖舞蹈｜动态沙画	沙龙学堂	上海
10月16日：穿越无锡群山--军嶂古道徒步活动	户外活动	上海
边际旅行  夏日放映会	文艺生活	上海
拍不出好照片，不是因为相机不够贵。	沙龙学堂	上海
"云青古琴传习,六次课就会弹小曲儿（三馆通用）"	文艺生活	上海
戏剧跨界艺术周特别企划 朱碧石养成计划	户外活动	上海
尽情做自己 | 前所未见的亚文化狂欢就在@1933鹦鹉螺嘉年华	派对聚会	上海
【说说】 | EFT的爱情国度	茶会雅集	上海
用音乐传递甜美的冬日恋曲，高级声乐/钢琴/吉他/尤克里里/体验课	沙龙学堂	上海
探秘枸杞岛:出海捕鱼、沙滩海鲜、日出日落（第2期）	户外活动	上海
11月19日：赏深秋美景--莫干山之行	户外活动	上海
手工皮具制作课程  | 头层牛皮拉护照包，短款钱包	DIY手作	上海
【盛夏光年音乐会】热爱文艺的吃货的周末好去处	派对聚会	上海
【ONEBOX特别策划】魔都最IN单身料理趴	派对聚会	上海
潜行者游戏――猫鼠大战	户外活动	上海
仅需568元，大师教你学钢琴，快速晋级钢琴大咖	文艺生活	上海
【义工招募】我们住在山里，劈柴，喂马，钓鱼，种花，身在青山，心自无忧~~~	户外活动	上海
[fete工作坊]植物染四日系统课	DIY手作	上海
【周末】秋季徒步莫干山，赏山景秋色，走蒋公道（1天活动）	户外活动	上海
"爱在夏天,渔山岛看日出寻最美星空，约上好友带上TA一起来吧"	户外活动	上海
探寻上海最隐秘海岛--大洋山徒步・看海・吃海鲜活动	户外活动	上海
形象管理・零基础班|夏日化妆小技巧，和脱妆”说 bye-bye !	沙龙学堂	上海
埃菲尔铁塔”油画主题活动 | 让我们携手来一趟笔尖上的巴黎之旅~~	DIY手作	上海
一起研究讨论交流「佛学」： 破人生大迷 佛研会	派对聚会	上海
神奇的水影画	DIY手作	上海
【闺蜜聚会】花园洋房里喝下午茶DIY小萌肉两不误	DIY手作	上海
时尚人物绘	文艺生活	上海
仙居最刺激的水线--丽人峡谷	户外活动	上海
（上海）陆上玩够了？来一次皮划艇之旅吧！	运动健身	上海
手机摄影―边走边拍武康路	沙龙学堂	上海
【线上微活动】性， 吴亦凡， 夜生活，让世界知道你的偏见！	派对聚会	上海
高尔夫球体验 | 尽情挥杆，在绿地和新鲜空气中享受美好生活	运动健身	上海
邂逅舟山朱家尖岛，浴阳光沙滩、观山海胜景（2日活动）	户外活动	上海
【乌托邦户外】7月1-3日清凉一夏，溯溪浙东大峡谷	户外活动	上海
配饰亲手做之一起来玩银黏土	DIY手作	上海
你该拥有这项技能|让大家都夸你是贤良淑德的女子	DIY手作	上海
避暑：仙山谷漂流.玩水.湿身和水果采摘1日活动	户外活动	上海
10月4日：宁波大松湾古道徒步	户外活动	上海
一起去天平山+木渎古镇，观满山奇石，赏江南胜景， 访古镇遗迹	户外活动	上海
【线上微活动】以美呼唤自由，理想与情怀邂逅	文艺生活	上海
7.2漂洋过海去舟山小洋山岛，登山、看海、观石	户外活动	上海
Min舞全球流行拉丁社交舞salsa入门体验	文艺生活	上海
chinigogo鸡尾酒培研工作室兴趣体验班招生	派对聚会	上海
6月25日中日韩交流会	派对聚会	上海
【中秋】去覆厄山，登山峰，赏梯田，触冰川遗迹，访火山岩柱	户外活动	上海
上海最隐秘海岛―大洋山：观海、徒步、抓螃蟹活动（已成行）	户外活动	上海
带着筷子去旅行成人红木筷子DIY	DIY手作	上海
让小时候的小提琴梦想此刻成真	文艺生活	上海
南方德云社”欢乐度周末 | 郭德纲弟子 笑乐汇相声会馆	暂不开放	上海
【上海地区】吉他公开体验课每天举行	文艺生活	上海
【10月02日】登顶太湖第一峰----缥缈峰1日徒步活动	户外活动	上海
时尚易逝，风格永存|如何定位自己的风格	派对聚会	上海
【周日】徒步上青古道、寻找兰若寺、赏幽幽竹海（6/19）	户外活动	上海
【咖啡入门篇】没试过手冲，别说你懂咖啡	文艺生活	上海
6月18日：大盘山古道徒步，结伴走进大自然	户外活动	上海
仅需158元， 世界名曲轻松上手， 成就你的钢琴梦想	文艺生活	上海
名贵木材大揭秘，木头什么的真的很简单	沙龙学堂	上海
薰衣草的浪漫之旅，就在中国的普罗旺斯	户外活动	上海
SideTours  静生活之道――香道	茶会雅集	上海
上海中韩语言文化交流会	派对聚会	上海
周六 精品优质身派对 | 周日 名校名企单身专场	派对聚会	上海
6/16知觉说说 | 微电影，大世界――以心理学视角谈《调音师》的浮世人心	沙龙学堂	上海
红樽坊6月初级品酒课	沙龙学堂	上海
极速前进 | 8.20首战世博园	户外活动	上海
【国庆】最新最好玩的VR游戏及视频10月1日-10月7日	派对聚会	上海
徒步莫干山，重走蒋公道（第2期）	户外活动	上海
琅琊琥珀 - 琥珀DIY端午活动	DIY手作	上海
【自酿啤酒速成班 】你的专属自酿啤酒之旅	DIY手作	上海
SideTours  狂野非洲鼓 唤起内心深处的激情	运动健身	上海
中日韩交流会	派对聚会	上海
孙俪娘娘私人教练的徒弟 带你体验时下最流行的普拉提床运动	运动健身	上海
【量子教室】国画0基础初学者教学体验课	沙龙学堂	上海
上海人民广场 尤克里里体验课 速成一首歌！	文艺生活	上海
亚洲25强调酒师带您品鉴美国顶级威士忌	派对聚会	上海
（端午节）去安吉看大竹海，探索最大瀑布群2日活动	户外活动	上海
【乌托邦】6.18 周末悠闲一日游 杭州的后花园大禹谷	户外活动	上海
【国庆狂欢】整夜high，轰趴在西塘！	户外活动	上海
（端午节活动）徒步莫干山，重走蒋公道	户外活动	上海
"零基础开花店专业课程,一对一教学定制完美专业课程"	沙龙学堂	上海
【四店通用】零基础水彩或水粉画体验课一次	DIY手作	上海
美好形象课:唯有美好的自己，才有力量让世界美好	沙龙学堂	上海
6/3知觉心理沙龙 | 亲密关系之杀手”――控制	沙龙学堂	上海
去崇明，看薰衣草、逗草泥马、漫步西沙（第2期）	户外活动	上海
2016极品绿茶专场品鉴茶会	茶会雅集	上海
顶级日本摄影大师作品收藏展――荒木经惟 ＆ 杉本博司	文艺生活	上海
每一颗咖啡豆都有一个故事｜长的是深夜，短的是人生	文艺生活	上海
走近陶艺之零基础拉坯，diy制作一件精美的素白瓷	DIY手作	上海
【懒人特别定制】六月专场 木作一个承载时光意义的时钟	DIY手作	上海
音乐剧 |《上海滩》，上海的烽火岁月和爱恨离别都在这里	暂不开放	上海
摄影基础入门掌握虚与实的魔法技能	沙龙学堂	上海
Going Crazy 锦辉可当代X鹦鹉螺市集	派对聚会	上海
SideTours  超能吃战队（真人户外游戏）	户外活动	上海
畅游佘山，周末休闲脱单活动	户外活动	上海
3步教你如何把孩子培养成宋仲基”	户外活动	上海
上海最隐秘海岛，大洋山观海徒步	户外活动	上海
礼仪课堂|以礼服人，职场礼仪为你加分	沙龙学堂	上海
零基础水彩画临摹 | 零基础的你同样可以完成一幅小清新的水彩画	文艺生活	上海
【量子教室*篆刻活动】给自己一份特别的礼物！	沙龙学堂	上海
遇・见――奔跑吧！向爱情出发！	派对聚会	上海
婚恋秘籍|如何通往自己的幸福殿堂	派对聚会	上海
小组极限减脂课程	运动健身	上海
【5.21-5.22休闲腐败线】天堂小蓬莱――苏州三山岛	户外活动	上海
爱宝玩亲子嘉年华-疯狂动物园	DIY手作	上海
【红樽坊5月初品课】一站式解决你对葡萄酒的困惑	沙龙学堂	上海
林雨阁佛研会 一起研究讨论交流「佛学」： 破人生大迷	沙龙学堂	上海
上海滑翔伞体验+骑行，摆脱”引力，带你遨游天空	户外活动	上海
私人形象定位 |告别买买买扔扔扔的换季模式	沙龙学堂	上海
【买一赠一】双人零基础古法拉胚或手工陶艺	DIY手作	上海
4-6岁艺术创想体验课19元{创智营徐汇区}	文艺生活	上海
欢度六一！大朋友们的节日，限时8折 仅79元大提琴体验！只有5个名额哦！	文艺生活	上海
画画很美上海站--免费学画画第一期	沙龙学堂	上海
意象对话 | 编织一个属于自己的白日梦”	沙龙学堂	上海
【量子教室】二胡0基础初学者教学体验课	沙龙学堂	上海
手绘旅行日志 | 旅行的意义， 最美的风景不只在相机里	文艺生活	上海
【找回玩心】 你有多久没像小孩子那样没心没肺的开心过了	沙龙学堂	上海
【量子教室】小提琴0基础初学者教学体验课	沙龙学堂	上海
（端午）漂洋过海去洋山，体验海岛风光和山海奇观	户外活动	上海
成人零基础舞蹈体验	运动健身	上海
百鬼夜行―终极百人撕名牌 4月29日	运动健身	上海
【量子教室】尤克里里+民谣吉他教学体验课(买琴送课程）	沙龙学堂	上海
相约炮台湾湿地：我在长江入海口等你！（上海）	户外活动	上海
Mother's Day  煽情一些又何妨	文艺生活	上海
SideTours  静生活之道――茶道	茶会雅集	上海
飞越疯人岛，海岛RunningMan，来一场沙滩篝火party！	户外活动	上海
彩铅入门 零基础就该这样玩！	文艺生活	上海
SideTours  边际旅行 舞魅弗拉门戈	运动健身	上海
5.14畅游佘山，周末休闲脱单活动	户外活动	上海
零基础欧式艺术插花体验	DIY手作	上海
连衣裙制作一日课！徐静蕾都去当裁缝了，你想不想也来体验一把？	DIY手作	上海
老洋房里画色彩 零基础 手绘钢笔淡彩	文艺生活	上海
[爆棚超值]老洋房里的零基础油画体验	文艺生活	上海
探索召稼楼：发现新派古镇之美	户外活动	上海
［中级班］短款钱包 原色意大利植鞣革-皮具工作坊	DIY手作	上海
『心理沙龙』为什么我们不能表里如一、心口一致”地沟通和表达？	沙龙学堂	上海
上海的威尼斯：一起发现朱家角古镇之美	户外活动	上海
【林雨阁】易经手诊教您掌握通过手纹知道身体状况	沙龙学堂	上海
无底溶洞探险――80米速降、60度攀岩，等你来挑战	户外活动	上海
让你的气质悄悄提升~形体芭蕾课程开始	文艺生活	上海
一次学会冲一杯浓缩咖啡、打奶泡、拉花	DIY手作	上海
谷雨”意境插花沙龙课程	文艺生活	上海
【单身进】4.16春风十里，不如与你相识上海大宁灵石公园	派对聚会	上海
树脂艺术：创造你的专属・1号线	DIY手作	上海
感受智利葡萄酒的独特魅力	讲座沙龙	上海
【占星主题沙龙】邀你一同探索不得不知的月亮星座	派对聚会	上海
60分钟让你成为优雅的钢琴诗人|一对一钢琴精品体验	文艺生活	上海
零基础迷你桌面油画DIY课程一次	文艺生活	上海
找回丢失的自己！	沙龙学堂	上海
全年心动体验咨询价――请帮助我，让我帮助您！	沙龙学堂	上海
"对话”艺术展\""Dialogue”?Exhibition of Contemporary Artists"	展览	上海
魅力形象体验活动――私人形象顾问，带你轻松玩转服装搭配、衣橱管理	沙龙学堂	上海
爱宝玩亲子乐园之亲子泼水”派对	派对聚会	上海
邂逅浪漫latte ，get拉花新技能	DIY手作	上海
【弦清咖啡小课堂】与咖啡的邂逅	沙龙学堂	上海
老外这么喜欢的地方，要不咱们也约起来走一个！	派对聚会	上海
桂花糕课堂|让李清照赞不绝口的香甜怎么制作	体验课	上海
其实你也可以亲手制作绘本|慢绘画课程	文艺生活	上海
2天就能设计出只属于自己的小黑裙	DIY手作	上海
热情国度的美酒佳酿邀您品尝	派对聚会	上海
大自然野生昆虫馆亲子套票+美式少儿英语探索游戏	沙龙学堂	上海
【成品打包】情人的礼物 绘幅肖像送给他(她）	文艺生活	上海
鼋头渚（无锡）赏樱，看太湖浩瀚壮阔之美（上海出发）	派对聚会	上海
大咖也爱相声，齐聚笑乐汇相声会馆	暂不开放	上海
【国庆】徒步《笑傲江湖》外景地新昌千丈幽谷+丹霞地貌+穿岩十九峰	户外活动	上海
春妆涌动！转（ren)角(ren)遇(shi)到(nv)爱(shen)	沙龙学堂	上海
【零基础油画】 拾回少时艺术家梦想 (专业老师指导+下午茶)	文艺生活	上海
周末课堂|茶道，是对生活最深的抚慰	体验课	上海
世纪公园拍鸽子学摄影光圈快门学构图	文艺生活	上海
旅拍达人是怎样炼成的	体验课	上海
上海西点城市生存一日营	户外活动	上海
尤克里里体验课，我们等着你来	文艺生活	上海
蝉鸣夏天里的音乐诗人 |零基础 钢琴”小提琴”体验课  （买一赠一）	文艺生活	上海
【虐线挑战】华东第三虐-三尖（4/8-10）	运动健身	上海
海归+精英?高端单身交友会	派对聚会	上海
双峰画展―旅美画家灵峰、郁峰双人展	展览	上海
插花课堂|花疗心性	体验课	上海
立体水彩画	DIY	上海
桑巴？恰恰？弗拉门戈？它是尊巴！来快乐的美体	运动健身	上海
【每周日】单反微单摄影快速入门摄影基础	沙龙学堂	上海
一夜春风 蓝充作品展	展览	上海
雅集活动---丙申春之茶乐”	讲座沙龙	上海
全球首个少女心事博物馆”特展登陆魔都！	展览	上海
高端精英派对 ●遇见最美的你	派对聚会	上海
零基础插花入门课程	体验课	上海
【红樽坊3月初品课】种一棵葡萄藤	体验课	上海
春季法国复古服饰沙龙	派对聚会	上海
让孩子在自信和快乐中学习钢琴，零基础钢琴免费体验！	体验课	上海
双人特惠油画体验【JingAn Lane Art Studio】	文艺生活	上海
"【特惠】\""绑架\""女神去华东香格里拉：仙居公盂"	户外活动	上海
从身心健康到生命觉醒~减压瑜伽	运动健身	上海
笑乐汇相声会馆新剧场演出	戏剧	上海
3月5日周六下午上海高端精英单身派对报名	派对聚会	上海
花丝首饰创作课程-----花瓣系列	DIY手作	上海
系列OH卡潜意识探索之个人成长	讲座沙龙	上海
笑乐汇相声星空广场明星店	戏剧	上海
笑乐汇相声10元抢票	曲艺	上海
在上海必看的一场戏―音乐剧《上海滩》	小型现场livehouse	上海
艺术工坊 | 画完这套婚纱，就把自己嫁了！	讲座沙龙	上海
公益讲座（上海）：诗意中国的古代建筑史	讲座沙龙	上海
体验影棚大片精彩，感受杂志封面上的你	定制方案	上海
唤醒一整年的活力 ― Awaken觉醒?鹦鹉螺春季创意市集	市集	上海
来一次【自我探索】的旅行 | 沙盘*意象*Oh卡*房树人，挑一个？	沙龙学堂	上海
登顶太湖第一峰	户外活动	上海
【心理咨询・公益行】如果你需要――Call Me！	文艺生活	上海
DIY手绘酒瓶\\面具\\布袋\\瓷器 【公司团建】	DIY手作	上海
读书会丨和村上春树&卡佛一起度过的周六早晨是怎样	讲座沙龙	上海
2016元宵雅集邀您参加	派对聚会	上海
声乐/钢琴/吉他/尤克里里1对1课程	文艺生活	上海
为温暖的夜晚 更添一份爱的喜悦	DIY手作	上海
一节45分钟纯粹【只教你尤克里里】的尤克里里体验课	文艺生活	上海
TOOMII咖啡の 与日本友人互相学习	沙龙学堂	上海
银饰+树脂diy艺术：创造你的专属	DIY手作	上海
一壶热水，半晌腔调，两分钟的咖啡造梦机器.	派对聚会	上海
音昱听堂农夫集市	派对聚会	上海
每周六19:15 收藏品and摄影沙龙	沙龙学堂	上海
上海辞旧迎新交友经典之夜专场”	派对聚会	上海
周末新玩法，足不出沪”体验西洋小提琴	暂不开放	上海
1/29 葡萄酒装X指南	派对聚会	上海
油画体验：雨中，全世界只有你和我	派对聚会	上海
余杭徒步及温泉	户外活动	上海
"新年,你好-CREA'TIF花艺体验"	体验课	上海
高尔夫心灵之旅 超值4次畅打套餐	运动健身	上海
YiFair奕菲市集2016年第一波	市集	上海
盲一场美国酒，说好没有赤霞珠	派对聚会	上海
手把手教您刺绣――亲自DIY一款芳香刺绣小香包，绝对实惠~	DIY	上海
周日 | 环杭州西湖群山徒步(1/17)	户外活动	上海
一对一单反微单摄影快速入门培训	文艺生活	上海
【公开课】了解犹太商人必学的神秘学问 ―九型性格沙龙	沙龙学堂	上海
爱的初”体验	派对聚会	上海
MR.BOOK【店e的好音】来MeLibrary真人图书馆，存储你的音乐人生	派对聚会	上海
「限额报名」香港拳王争霸赛亚军”私教一对一，教你打拳击，快准狠	运动健身	上海
非去不可旅游广告放映交流会	讲座沙龙	上海
美式即兴喜剧《HOHOHO 遇见 HAHAHA》	戏剧	上海
远方书屋圣诞趴	派对聚会	上海
活捉圣诞老人奇妙游园会	市集	上海
跨年派对｜笑玩一整年	派对聚会	上海
一场秘密的行为艺术|茶艺、茶道、茶文化讲习课	茶会雅集	上海
Single Singers阿卡贝拉同好会，期待爱唱歌的你	文艺生活	上海
一对一私教健身 个性化量身定制	运动健身	上海
「心理咨询」公益活动――如果你需要，Call me！【知觉公益行】	文艺生活	上海
爱阿卡贝拉，来Single Singers年度音乐会	小型现场livehouse	上海
盛世英豪职业搏击俱乐部综合格斗体验课	运动健身	上海
我们就要画出一片星辰大海！	文艺生活	上海
中国六大类茶品鉴会 | 好茶需要静心细品	茶会雅集	上海
浴衣yukata制作一日课（第四期）！	派对聚会	上海
爱挑战爱刺激、爱健康，那就一起来攀岩吧	运动健身	上海
「一个木质手镯+一枚木质戒指+半圆珍珠贴片+平底水钻」收不？	文艺生活	上海
【黄兴公园】盛聚高尔夫	运动健身	上海
『情感沙龙』你那爱情的容颜――用意象对话的视角看两性相处	派对聚会	上海
和服yukata制作一日课（第四期）！ 徐静蕾都去当裁缝了，你想不想也来体验一把？	派对聚会	上海
每周二深入学习研究 面相 中的福祸	沙龙学堂	上海
解梦――我们做的梦，在向我们传达什么信息，解答梦和潜意识的关系	派对聚会	上海
【描绘心中的画】零基础油画体验	派对聚会	上海
超值写实素描单人入门体验	派对聚会	上海
aMaze真人密室逃脱，等待你的挑战！	派对聚会	上海
日系裤子制作一日课！ 徐静蕾都去当裁缝了，你想不想也来体验一把？	派对聚会	上海
「味蕾系的面包」相遇「视觉系的你」，拿什么来拒绝这次烘焙？	DIY手作	上海
沙发旅行分享会 | 西班牙旅行分享餐会	派对聚会	上海
Me Cafe 专业单品手冲咖啡及品鉴课程	派对聚会	上海
节日的手作礼物被承包了：自制手作棒棒糖蛋糕+戚风Cupcake	DIY	上海
羊毛毡手作 & 心意下午茶：重拾手作的快乐，找寻一心一意好时光。	派对聚会	上海
零负担夏季穿搭美人！―私人形象顾问带你玩转服装搭配＆衣橱管理	沙龙学堂	上海
红樽坊双11预热――脱光派对”	派对聚会	上海
3000年等待换一次相逢，如今有琴等你（淮海馆）	文艺生活	上海
"3000年等待换一次相逢,如今有琴等你（中山馆）"	文艺生活	上海
【限时优惠】自制鸡尾酒，享受醉人的初秋夜晚。	派对聚会	上海
【周四】 如果你也爱挑战爱刺激、爱健康，那就一起来攀岩吧！（10/29）	运动健身	上海
万圣节的免费直升机大奖 | 你与陌生鬼有个约会！	派对聚会	上海
【限时优惠】万圣节南瓜雕刻大赛 & 尖叫冷餐会	派对聚会	上海
女神养成午餐之水果拼盘DIY	DIY手作	上海
预热万圣节杀人之夜，寻找智商情商双爆表的杀手”！（参与即有万圣节奖品）	派对聚会	上海
【限时优惠】学做手冲单品，做一名咖啡匠人（十月最后一次手冲咖啡课程，附赠咖啡品鉴分享）	派对聚会	上海
【限时优惠】十月最后一次咖啡拉花分享会，教你玩转心形拉花	派对聚会	上海
10月1日-7日（国庆每日举行）阳澄湖莲花岛大闸蟹	户外活动	上海
去什么鬼”鹦鹉螺市集?万圣嘉年华轧闹猛	派对聚会	上海
[红酒品鉴]做一名优雅的品酒达人！	派对聚会	上海
香港配饰设计师品牌ThinkerLab 010  品牌见面会 上海站	派对聚会	上海
长途野外骑马逛森林公园	运动健身	上海
万圣节特别款鸡尾酒助阵，让你尖叫的鸡尾酒狂欢趴！	派对聚会	上海
【知觉心理・公益行】「心理咨询」公益活动――如果你需要，Call me！	文艺生活	上海
【每周日】把心爱的人逼到墙角，让TA无处可逃！壁球场里的壁咚说爱你，你get√了吗	运动健身	上海
Me Cafe 专业意式咖啡制作及拉花课程	派对聚会	上海
意式咖啡全课程：一起学习咖啡+牛奶”的乐趣。	派对聚会	上海
【限时优惠】学做樱花冻芝士：当粉嫩醉人的樱花落在冻芝士上。	派对聚会	上海
红樽坊10月初级品酒课	派对聚会	上海
咖啡品鉴课程：咖啡畅饮，教你品鉴5种风味独特的咖啡香。	派对聚会	上海
12月30日-1月2日（2017元旦）行摄霞浦大嵛山岛	户外活动	上海
【五一】漫步徽杭古道--浙江十大徒步线路之首	户外活动	上海
意式咖啡基础课程：在咖啡上画画。	派对聚会	上海
咖啡拉花课程：牛奶与咖啡的艺术碰撞。：	派对聚会	上海
伍迪・艾伦系列电影作品：《蓝色茉莉》，《午夜巴黎》，《赛末点》，《只管有用》放映	电影	上海
技多不压身，周末咖啡拉花”开课啦！	派对聚会	上海
手冲咖啡课程：做一名咖啡匠人”。	派对聚会	上海
学做创意杯子蛋糕：烘焙界的小精灵，低调亦奢华的Cupcake	派对聚会	上海
国庆假期：Me Cafe咖啡匠人”开课啦！	派对聚会	上海
中秋特别主题：好吃の冰皮月饼DIY，制作一份美味の心意	体验课	上海
Me Cafe 鸡尾酒狂欢趴：吹清凉小风，喝自制鸡尾酒。	派对聚会	上海
周末两人DIY畅玩版	DIY手作	上海
学做抹茶、彩虹冻芝士，变身美丽小厨娘。	派对聚会	上海
学做樱花冻芝士：当粉嫩醉人的樱花落在冻芝士上	派对聚会	上海
11月12日-13日漫步徽杭古道--浙江十大徒步线路之首	户外活动	上海
"12月31日（2016元旦）行摄中国最美的滩涂霞浦,游中国十大最美的海岛之大嵛山岛"	运动健身	上海
【鹊缘交友】9.20久爱你”8分钟交友活动	沙龙学堂	上海
蛋黄酥、鲜肉月饼，边学边做边吃，并赠送冰皮月饼课程一次。	派对聚会	上海
跟着BBC去看英国小镇上50位喵星人的生活百态	派对聚会	上海
Me Cafe的解忧杂货铺：塔罗世界的心理映射。	派对聚会	上海
嘈杂中的幽静－品一杯来自山里的味道	DIY手作	上海
"对她来说，性感是一件毫不费力的事：「初吻」,「安娜・卡列尼娜」,「勇敢的心」,「芳芳」在私人影院体会女神的魅力"	电影	上海
连衣裙制作一日课（第二期）！ 徐静蕾都去当裁缝了，你想不想也来体验一把？	派对聚会	上海
"【徒步】轻装穿越龙须山,行走如沙漠般的山脊(9/25-27 )"	派对聚会	上海
抓住夏天的尾巴，豪饮自制鸡尾酒。	派对聚会	上海
「嘴角 以食会友」就爱做西餐，在车库改造的空间招待大家哟	DIY手作	上海
遇见未知的自己――塔罗占卜	沙龙学堂	上海
【鹊缘交友】天凉好个秋――草地上的遇见	派对聚会	上海
【 零壹象限 VS 小小空间 】 探秘色彩能量?减压涂色绘画+解读色彩心理	派对聚会	上海
9月最浓的爱意，是为家人亲手制作月饼。	派对聚会	上海
【摄影】括苍山迎接第一曙光、赏神奇云海、风车、日落（9/19-20）	户外活动	上海
纯银创意耳饰/挂件DIY，独一无二の手作体验	派对聚会	上海
【9.12-13】龙王山逆溪山涧|桥降	派对聚会	上海
周末清晨的第一杯咖啡，来Me Cafe 边学边做边喝	派对聚会	上海
服装搭配活动体验――打造你的专属穿衣范儿，穿出时尚，搭出品位！	派对聚会	上海
「每周心理」让我们打开神秘大门，去往你那无意识的心房吧！	派对聚会	上海
连衣裙制作一日课（第二期）来了!！徐静蕾都去当裁缝了，你想不想也来体验一把？	派对聚会	上海
让身体线条更柔美的「球瑜伽」来咯~	运动健身	上海
喜爱画画和diy的你不能错过|手绘马克杯、烛台、盘子~	DIY手作	上海
童话时光：来自哈利波特的美味零食IIIの巧克力坩埚	体验课	上海
「波斯王子：时之刃 」放映：一场充满异域风情の冒险之旅	电影	上海
3D打印？ 眼见为实！	派对聚会	上海
秋天快来了，做一回设计师 制一回手工首饰	派对聚会	上海
学做手冲单品，做一名咖啡匠人。	派对聚会	上海
【WEEK 8: Game Night】Delicious Wednesday 美味周三英语沙龙	派对聚会	上海
连衣裙制作一日课（第二期）来了！徐静蕾都去当裁缝了，你想不想也来体验一把？	派对聚会	上海
「仅限12人」葡萄酒初级品鉴第二期 ・ 为你细数葡萄酒的那些事儿	派对聚会	上海
你值得拥有更好的银饰，随心所欲 独一无二	派对聚会	上海
热爱美食和交友，做了外面吃不到的西菜，来我家做客吧	DIY手作	上海
中秋未到先「手作」祝福，广式or冰皮月饼自己做	DIY手作	上海
「再次出发」放映：今年夏天最甜蜜的约会电影	电影	上海
学做冻芝士蛋糕，变身高冷的烘焙美厨娘	派对聚会	上海
寻宝猎人4.0版：无尽的杀戮 | 城堡里的疯狂实弹枪战游戏	运动健身	上海
烘焙+手作 ・ 手作时光带你走进童趣的卡通世界	派对聚会	上海
【法西斯小长假】寻找童话中的渔山岛	运动健身	上海
单人零基础油画体验	派对聚会	上海
夏日尤克里里聚会 亲子活动	体验课	上海
文艺小技能「橡皮章+软木手柄＋棉布手机袋+温馨下午茶」一次打包全给你	DIY手作	上海
爱上葡萄酒―品酒师课程体验	文艺生活	上海
上海市最火的RM跑男线下游戏活动	运动健身	上海
Fun Knights放游族?鹦鹉螺市集 ――城会玩大派对（早鸟票正当时~）	派对聚会	上海
赵鹏 行吟” 全国巡回歌友欣赏会 上海站	暂不开放	上海
咖啡瘾患者的狂欢趴：品鉴5种风味独特的咖啡香。	派对聚会	上海
女子防身术，用真实的力量让自己变强！	运动健身	上海
【唱过】录制一首你自己的「单曲」（不限时，需预约）	派对聚会	上海
裙子制作一日课（第一期）徐静蕾都去当裁缝了，你想不想也来体验一把？	派对聚会	上海
和我的Ta一起默契七夕” 油画拼画	派对聚会	上海
寻宝猎人3.0版：无尽的杀戮 | 最疯狂的实弹枪战游戏	运动健身	上海
情侣DIY套餐 ・「仅限情侣，单身汪不要进来・・・」	派对聚会	上海
「一日游」长途野外骑马逛森林公园	派对聚会	上海
刀即是笔 | 黑白之间 体会木刻版画之美	DIY手作	上海
伴着钢琴的旋律，去花的尽头	文艺生活	上海
【周四特惠】别说你不想滑冰~还有冰壶比赛可以玩~	运动健身	上海
「我就要不一样」手绘一个独一无二的帆布包，我，就是品牌	派对聚会	上海
若ta为你画一件T恤，你们会成为怎样的风景？	派对聚会	上海
健康怎么吃出来？「人生年轻20岁」的吃法是什么呢？	派对聚会	上海
【Me Cafe咖啡拉花分享会】做一杯心形”拉花咖啡，送给最爱的自己	派对聚会	上海
「咖啡品鉴」那些歪果仁真正喜欢喝的咖啡~	派对聚会	上海
夏日甜点之法式柠檬塔	派对聚会	上海
六根鲁班锁制作，七窍玲珑孔明锁	DIY手作	上海
Sexy Jazz！甩汗也要性感的甩！	运动健身	上海
【扇过】「轻罗团扇描热浪」 ・ 3小时手作，夏天自己手中的清凉风景	派对聚会	上海
「只限一周，八月八折！」盛夏清凉零基础大提琴体验：文艺患者的忠诚旧爱，都市白领的热恋新欢	暂不开放	上海
让你的气质悄悄提升~形体芭蕾	运动健身	上海
诉说历史中最真实的「旗袍」，民国女人的样子	派对聚会	上海
「每周技能」告诉你，其他行业都有哪些黑幕”？	派对聚会	上海
「每周心理」家，如何塑造了你和你的爱情？	派对聚会	上海
「独家首发・三天两夜」新开放海岛，新晋马尔代夫中国版！能否等到你・・・・・・	运动健身	上海
纯银创意耳饰DIY，一份独一无二的七夕节礼物	派对聚会	上海
【WEEK 7 Literature: Famous Poems】Delicious Wednesday 美味周三英语沙龙	派对聚会	上海
「美周六 ・ 舞蹈篇」3个小时清凉Salsa舞会 ・ 高手低手谁care，我要的是跳舞！	派对聚会	上海
"魅力形象提升体验――服装搭配、衣橱管理指导咨询，提升形象,惊艳你自己"	派对聚会	上海
【中秋&国庆线】何必上班？！北疆|童话喀纳 ― 行走四国边境	运动健身	上海
用杜海涛的方式锻炼，这个夏天，想不瘦都难	运动健身	上海
DIY印章、彩铅、水彩卡片，自己做戳自己盖~	DIY手作	上海
【潜过】夏天就要浪！潜水海底世界GO！GO！GO！	运动健身	上海
经典简约复古范手拿信封包、ipad包	派对聚会	上海
饼干遇上可可， 我们刚好一起慢慢热融化	DIY手作	上海
「只限一周」8月8折― 成人零基础钢琴体验：做大艺术家，任何时候都不晚	暂不开放	上海
孩子的新体验 书法培训/暑假班书法/硬笔/软笔	文艺生活	上海
零基础体验：敲响西班牙的卡洪鼓	文艺生活	上海
「旅行分享・边吃边聊」：我从英国开始的世界行	派对聚会	上海
只属于你的「中式」下午茶	派对聚会	上海
怎样都要潮潮的，还不快DIY一个自己的包包出街？	DIY手作	上海
【品过】「仅限12人」红樽坊初级品酒课，教你如何品葡萄酒（需预约）	派对聚会	上海
星空棒棒糖DIY，来自星星的动漫	DIY手作	上海
摒弃错误瘦身，马甲线让你成为吸睛人气王~	运动健身	上海
「仲夏私享会」鹦鹉螺周年狂欢来袭！ （早鸟票还有三件惊喜噢~）	派对聚会	上海
【飘过】乘一叶独木，泛舟泰晤士小镇，体验不一样的欧式风情「一日游」	运动健身	上海
「限时优惠」心里一直有一个和小提琴有关的梦想，梦想我也能奏出这样的歌曲―零基础成人小提琴体验	暂不开放	上海
【爱过】埋进心底的遇见 ― 8.2日八分钟交友，你会遇见谁？	派对聚会	上海
限时优惠 | 超萌爆笑儿童剧《小红帽》	戏剧	上海
我用一首钢琴曲 向你表白（害羞）	文艺生活	上海
「仅限女生」一个美丽厨娘必备哪些技能？	DIY手作	上海
烘焙+手作 ・ 手作时光带你走进蔓越莓的世界	派对聚会	上海
纯银耳环or项链挂件DIY，一份独一无二的七夕节礼物	派对聚会	上海
胡萝卜蛋糕DIY，还能补充维生素噢~	派对聚会	上海
【周四特惠】一起帅气地射箭去！不限箭支数量+桌球+桌游	运动健身	上海
焙茶是玩火，而斟五杯好茶，除了细心，还需等待	派对聚会	上海
天哪，可以「吃」的多肉！萌宠饼干or多肉杯子，你忍心吃哪个?(??ω???)	DIY手作	上海
当建筑师太难，不如来玩花艺吧！	派对聚会	上海
生命的线条-零基础海娜手绘	体验课	上海
「旅行分享・边吃边聊」在肯尼亚，和动物遭遇的那些事儿	派对聚会	上海
「美周六」3个小时清凉舞会派对 ・ 不知可否请你共舞一曲？	派对聚会	上海
盛夏清凉零基础大提琴体验：文艺患者的忠诚旧爱，都市白领的热恋新欢	暂不开放	上海
「一日行」三伏天，来莫干山避暑~	商业	上海
来做一个安静的美厨娘，创意杯子蛋糕DIY	派对聚会	上海
希腊风情迷马赛克 | 马赛克烛台、风灯、台灯diy活动	派对聚会	上海
猫咪陪你一起画画	派对聚会	上海
聊聊二战军服那些事之「铁甲华胄」	派对聚会	上海
「一个木质手镯+一枚木质戒指+半圆珍珠贴片+平底水钻+一杯饮」收不？	DIY手作	上海
周末清晨的第一杯咖啡，来Me Cafe 边做边喝。	派对聚会	上海
一针一线中的工艺――DIY泰迪熊公仔	派对聚会	上海
攀岩，速降，溶洞探险，还有漂流！	运动健身	上海
零基础油画体验  初见静待	派对聚会	上海
【艺分之捌社】音乐小白的福音！优雅小提琴零基础集体课	暂不开放	上海
天气未热也应养生 ・ 三伏贴试贴	文艺生活	上海
夏天，做一个银饰手链阳光心情~	派对聚会	上海
每个人心里都有一方世界，开启潜意识之门，寻觅你内心的房子	派对聚会	上海
36元私教一对一，快来练出马甲线	运动健身	上海
Delicious Wednesday 美味周三英语沙龙	派对聚会	上海
壁球馆里壁咚说爱你：都是壁咚，怎么人家就成功了呢	运动健身	上海
软陶+多肉+微景观创意组合	派对聚会	上海
魅力形象体验之女神季――形象顾问打造新女神，1小时教会你服装搭配	派对聚会	上海
心理画外音 ・ 画一幅房、树、人，为你一对一解读内心奥秘	派对聚会	上海
苏州灵岩山七山穿越 体验苏州的七尖	运动健身	上海
"惊险与刺激同行,感受华东第一水线--楠溪江"	运动健身	上海
【七月影展】看一部好电影就像读一本好书	电影	上海
霸道总裁爱上我 ― 「五十度灰」(未删节版)， 在「私人影院」与格雷先生不见不散	电影	上海
每次出走都会有理由，「伊朗之旅」边吃边说咯~~	派对聚会	上海
「限额抢票」棱镜?鹦鹉螺市集又来咯！开始奇妙感官之旅~	派对聚会	上海
自己动手，做一杯意式咖啡	派对聚会	上海
最后一场手冲咖啡，约吗	派对聚会	上海
私人形象顾问全城通告：参加服装搭配体验，进化成女神！	派对聚会	上海
年华是最好的「情书」，写封信给未来的自己	电影	上海
马陆葡萄主题公园欢乐采摘，还有驿岛酒店风情一夜（酒店+门票）	派对聚会	上海
时光里的陪伴 | 定制父亲节甜蜜味道	派对聚会	上海
「中国风」or「和风」由你选，手绘团扇拥抱清凉一夏！	文艺生活	上海
我有一个音乐梦想，私房精品小提琴一对一体验	暂不开放	上海
零基础ukulele体验课：让我们弹弹人生，道具是尤克里里	暂不开放	上海
海娜临时纹身 ・ 够潮你就来	派对聚会	上海
日本小原流花道体验课	文艺生活	上海
生化危机蔓延上海，你就是walking dead！	运动健身	上海
巴洛克浪漫大提琴一对一体验――海派理想生活初体验	暂不开放	上海
我们只DIY关于轻松熊的一切	派对聚会	上海
colorful鹦鹉螺市集 ・ 魔都最好玩的市集嘉年华来咯！预售开始！！	派对聚会	上海
夏日「第一封信」，寄自复古信封包	派对聚会	上海
玻璃杯创意DIY手绘	DIY手作	上海
邀请函：一个尊重电影的私人影院想约你看电影	电影	上海
画出你心中的星空 ― 零基础绘画体验	派对聚会	上海
周末教你做咖啡：手冲咖啡 & 意式咖啡	派对聚会	上海
黑色星期五电影专场：「死亡录像3」の惊叫之夜，你准备好了没?	电影	上海
梦回上海滩 #哎呦city tour周末走起#	派对聚会	上海
学就要有样儿――定制尤克里里一对一体验课	暂不开放	上海
特惠！2015合气道夏日招集中！	运动健身	上海
「橡皮章+软木手柄＋棉布手机袋+下午茶」一次打包全给你	派对聚会	上海
阅读、鲜花、下午茶，成年人的电影童话	派对聚会	上海
优雅3小时，零基础也能学油画	派对聚会	上海
好咖啡，自己冲	派对聚会	上海
「小提琴」从零基础到精通，每周45分钟，享受古典音乐时光	文艺生活	上海
做一个捕梦网，带着印第安的祝福和ta去远方~	派对聚会	上海
随心所欲，把皮革diy成你自己最想要的样子就好	派对聚会	上海
「限时优惠」谁说我们不懂艺术，画给ta看 ― 印象派零基础油画体验	文艺生活	上海
夏天就要来啦，还不快DIY一个自己的包包出街？	派对聚会	上海
8分钟的遇见，聊出一场心动（女生已满，仅限男生）	派对聚会	上海
Me Cafe 教你玩手冲咖啡（第三期）限额报名中~	派对聚会	上海
爱她，亲手为母亲制作棒棒糖蛋糕”	派对聚会	上海
「半价抢票」特逗又来咯！动漫潮流GO起来	派对聚会	上海
周末来长兴岛骑骑车吧	运动健身	上海
「上海懒人专属」找个大厨上门烹调美食	DIY手作	上海
每周末 深圳大鹏古城+万绿野炊+杨梅坑浪漫单车一日游	户外活动	深圳
手工压花|拾掇时光，亲手来装点你的生活	DIY手作	深圳
「烛光派对」+「黑暗中对话」每周六晚深圳地区单身男女浪漫之约	派对聚会	深圳
三天化妆班，基础班加提升班，专业指导各式妆容快速掌握	沙龙学堂	深圳
体能训练指导课――动作标准了，才能练出效果	运动健身	深圳
零基础美妆素描 ，还有你喜欢的化妆哦	文艺生活	深圳
惠州哈施塔特----奥地利小镇异域风情 怡情谷温泉 一天游	户外活动	深圳
探索 深圳鼓浪屿” 古城----较场尾1日游	户外活动	深圳
「狂欢派对」每周六晚深圳地区单身男女狂欢派对	派对聚会	深圳
狮子岛穿越：探寻原始海岸线，美丽沙滩火锅1日活动	户外活动	深圳
【太阳裙DIY】花二三小时 收获一份专属你的美好	DIY手作	深圳
刺绣diy | 一针一线都是在聆听自我的倾诉	DIY手作	深圳
任意依恋  任意手链	DIY手作	深圳
雨中斑斓 无非社交油画	文艺生活	深圳
架子鼓/爵士鼓基础课 一节课学会合奏一首乐曲	文艺生活	深圳
【韩式素颜妆】揭开韩剧女主角零妆感的秘密	沙龙学堂	深圳
木作一个承载意义的时钟 | 打造质感生活，惊艳你的时光	DIY手作	深圳
要想见高富帅、白富美，来”高尔夫”相约	运动健身	深圳
最给力的声乐课 | 一节课让你学会用气唱歌、演讲	文艺生活	深圳
【每周日】中国最美八大海岸线之一东西冲穿越一日游	户外活动	深圳
小提琴一对一体验课程 |  学一种优美的乐器，过一个轻松的周末	文艺生活	深圳
【周末】十里银滩+虎洲岛环岛徒步+吃海鲜一日活动	户外活动	深圳
【每周六、日】增城绿道踩单车+天南第一梯白水寨瀑布生态之旅	户外活动	深圳
【周末】骑行深圳最美溪谷杨梅坑，探索《美人鱼》拍摄地	户外活动	深圳
如何让零基础的你，一天之内快速学会化妆！	文艺生活	深圳
单人小班基础化妆课+提升化妆课套餐 针对性教学 包教包会！	沙龙学堂	深圳
这种地方还是学跆拳道的？听说学跆拳道有一种气质哦！	运动健身	深圳
优美体态--如何纠正不良体态习惯迅速提升气质	沙龙学堂	深圳
一节课学会ukulele弹唱不是梦――单次课	文艺生活	深圳
【国庆】西冲沙滩露营、游泳、烧烤、看日出2日活动	户外活动	深圳
爱情是两个人一同成长的一段旅程，录音棚深情对唱	文艺生活	深圳
英西峰林走廊徒步、探索神秘千年瑶寨，瑶族篝火晚会	户外活动	深圳
泰拳体验 | 释放你心中的野兽	运动健身	深圳
脑子太涨了，到这吧，周末去处最佳选择	文艺生活	深圳
零基础油画体验，9月更有新惊喜	文艺生活	深圳
就算你用一万块的相机，不掌握三要素，你还是拍不出好照片	沙龙学堂	深圳
【9.24 韩式素颜妆】揭开韩剧女主角零妆感的秘密沙龙	沙龙学堂	深圳
【每周日】南澳珊瑚潜水 快艇出海烧烤BBQ一日游	户外活动	深圳
【国庆黄金周】九天深度游 额济纳金色胡杨林、巴丹吉林沙漠、茶卡盐湖醉美金秋	户外活动	深圳
一咖啡――度个娴静时光，玩玩粘土喝喝咖啡！	DIY手作	深圳
国庆假期：惠东双月湾十里长沙滩露营 烧烤 篝火晚会 看日出 观双月湾全景	户外活动	深圳
乐橙岛|【18课时】钢琴体验，成就你儿时梦想！【深圳8店通用】	文艺生活	深圳
国庆假期：三门岛露营、快艇冲浪、登海誓山盟峰	户外活动	深圳
国庆假期一天活动：南澳珊瑚礁潜水 走入神秘的海底世界潜水	户外活动	深圳
【国庆节】寻访广西最美黄瑶古镇、食民间美食、体验少数民族风情	户外活动	深圳
大鹏古城+万绿野炊+杨梅坑单车	户外活动	深圳
乐橙岛|99元3节课21天免费练琴 2首钢琴曲+12首练习小曲 【深圳8店分店】	文艺生活	深圳
云浮新兴县金水台房车之旅	户外活动	深圳
【零基础服装设计DIY】自己制作永恒经典小黑裙	DIY手作	深圳
*鲸鱼座手作*植揉头层牛皮皮带	DIY手作	深圳
做自己的催眠师：失眠心理治疗，从此睡个好觉！	沙龙学堂	深圳
零基础永生花油画，绘画加插画的创意手工画	DIY手作	深圳
【周末】深圳最美溪谷杨梅坑骑行，探索《美人鱼》拍摄地	户外活动	深圳
眉型不好？不会画眉？――时尚眉型解析设计与画法	文艺生活	深圳
零基础带你玩转高尔夫 | 开启高尔夫人生，尊享纵情挥杆的体验！	运动健身	深圳
"乐橙岛|3节1对1教学课+3周内多次练琴指导，0基础成人学琴\""99元\""抢订！"	文艺生活	深圳
8.27 影者之心电影论坛 | 戈达尔 -- 赤道上的思考者	派对聚会	深圳
给自己编织一份美丽！手工编织DIY	DIY手作	深圳
尤克里里之一天上手一门乐器是一种怎样的体验	文艺生活	深圳
谈恋爱不如跳舞――舞出好身材	运动健身	深圳
优雅女人形体仪态修炼----超值月卡低价秒抢	运动健身	深圳
东方花艺体验课 | 对静美花叶世界的解读	DIY手作	深圳
跆拳道【击破】沙龙――成为一拳超人，打飞烦恼压力	运动健身	深圳
私人教练体验课程 | 细腰时代已过去，马甲线才是王道！	运动健身	深圳
在现代风录音棚里学唱歌，让你拥有自己的主题曲	派对聚会	深圳
健身驿站首次体验卡	运动健身	深圳
在家葛优躺，不如学吉他	文艺生活	深圳
零距离体验手绘，制作手绘茶具	DIY手作	深圳
98元零基础彩铅体验（8开）| 在一间闹市中的小画室，画一幅此刻的画。?	文艺生活	深圳
乐橙岛 | 1对1  零基础45分钟钢琴体验课	文艺生活	深圳
爱的初体验 | 唱一首歌送给你爱的人	文艺生活	深圳
人人都是艺术家--零基础自助油画下午茶	文艺生活	深圳
零基础花艺课--养花插花居家艺术花艺时尚沙龙	DIY手作	深圳
每周六惠东双月湾十里长沙滩露营 烧烤 篝火晚会 看日出 观双月湾全景	户外活动	深圳
乐橙岛 | 原价900，限时抢99元【深圳8店通用】	文艺生活	深圳
独自一人撸琴没味道？来！这里有一个音乐全家桶！	派对聚会	深圳
东方花艺公开课 | 感受一花一草中蕴含的淡淡禅意	文艺生活	深圳
清新一夏，零基础学会尤克里里弹唱	文艺生活	深圳
成人零基础弹钢琴45分钟体验课	文艺生活	深圳
零基础喜乐学院派民族、美声高级声乐体验课	文艺生活	深圳
翻唱录音个人套餐| 快乐唱歌，留下美好印记	文艺生活	深圳
你与音乐之间只差一个尤克里里	沙龙学堂	深圳
你的沙盘游戏等你来 | 激活你天的生自愈力量，释放内心压力	沙龙学堂	深圳
满满的爱编制出一夏清凉	DIY手作	深圳
Social Healthy Brunch仲夏乐活早午餐社交趴	派对聚会	深圳
打击乐的灵魂节奏，这次就在你的手中呈现	文艺生活	深圳
14天打造人鱼线、马甲线，这个夏天让我们秀起来！	运动健身	深圳
当七夕情人节遇上陶艺	DIY手作	深圳
【私人包厢影院】属于你自己的个人空间，留给你1段美好记忆	户外活动	深圳
10月22日 精品杯子蛋糕制作×零基础油画＊美跟拍	DIY手作	深圳
剑道修心，感受日式生活美学	运动健身	深圳
零基础钢琴弹唱课|像周董一样自弹自唱，学会两首弹唱曲目	文艺生活	深圳
台风天适合走货？台风天更适合学架子鼓！	沙龙学堂	深圳
一咖啡海娜纹身DIY手绘活动――以手绘出的短暂将成美好	DIY手作	深圳
制作永不凋谢的鲜花	DIY手作	深圳
钢琴15课时套餐 | 让您学的更加系统，遇见钢琴，遇见更好的自己	文艺生活	深圳
【深圳8店通用】成人学钢琴，2节课学会弹奏3首歌，结交一群好友！	文艺生活	深圳
终朝采蓝，不盈一b | 亲手扎染一件独一无二的草木染作品	DIY手作	深圳
用一张照片证明你是你妈亲生的”科科	文艺生活	深圳
喜乐KTV麦霸唱歌训练营~教你唱好心目中的那首歌	沙龙学堂	深圳
西冲沙滩露营、游泳、烧烤、看日出2日活动	户外活动	深圳
哎呀音乐丨美女老师带你HIGH带你飞	沙龙学堂	深圳
让你神采奕奕电力十足的法宝--眼线美眼技【快速学】	沙龙学堂	深圳
小提琴 基础体验课程 | 学点自己喜欢的音乐，生活不留遗憾	文艺生活	深圳
0基础吉他弹唱入门体验课2节（原价480）	文艺生活	深圳
Ukulele零基础入门体验课 | 浪漫的音乐，浪漫的夏天	文艺生活	深圳
最后两期 深圳鼓浪屿较场尾”沙难戏水、摘火龙果、杨梅坑单车一日游	户外活动	深圳
【周末】最美海滨栈道徒步、观景、游泳1日活动	户外活动	深圳
这一首简单的歌，我用尤克里里弹给你听	派对聚会	深圳
苦恼明天穿什么，不如自己动手做 || 服装设计	DIY手作	深圳
【跟我一起动次打次】――架子鼓公开课	沙龙学堂	深圳
手工DIY亲子手工数字油画	DIY手作	深圳
汕尾百乐沙滩露营+海鲜火锅+看日出+赏断情涯美景2天游	户外活动	深圳
深圳避暑哪里好？一起去麻水凤溯溪	户外活动	深圳
零基础  学打高尔夫球，来吧！	运动健身	深圳
哎呀音乐纯K欢唱趴，美女老师带你唱出新声”	派对聚会	深圳
名师带你吉他入门（想自学吉它的童鞋看过来）	文艺生活	深圳
古筝 教学 基础体验课	文艺生活	深圳
每周六.三门岛露营、快艇冲浪、看日出、登海誓山盟峰休闲两日游	户外活动	深圳
口才训练 | 克服发言紧张，改变性格内向，提升影响力！	沙龙学堂	深圳
【旗袍制作课】DIY定制我的专属旗袍	DIY手作	深圳
架子鼓/爵士鼓 基础课-一节课合奏一首乐曲	文艺生活	深圳
双人趣味钢琴体验之旅	文艺生活	深圳
【周末】最美时光，一起穿越最美海岸线--东西冲活动	户外活动	深圳
清远古龙峡漂流+万丈瀑布群探险+小北江观光一日游	户外活动	深圳
一起拍电影 | 进入异度空间寻找你的奥斯卡！	文艺生活	深圳
【线上微活动】走进大师的世界，一节课告别书法小白	沙龙学堂	深圳
个人单曲录制 | 专属于你的歌，为自己录一张CD	文艺生活	深圳
【周末常规】每周日增城绿道踩单车、天南第一梯、白水寨瀑布一天生态之旅	户外活动	深圳
我要做麦霸，大声放歌	文艺生活	深圳
【优雅女人】之深谙法式优雅真谛，成就气质魅力女人	文艺生活	深圳
【零基础】教你制作一线大牌时装	沙龙学堂	深圳
【周末常规】三门岛露营、快艇冲浪、看日出、登海誓山盟峰休闲两日游	户外活动	深圳
特工系列―X计划	派对聚会	深圳
不知为什么我就想玩插花	DIY手作	深圳
【情感沙龙】知心爱人----如何做一个会说话的女人	沙龙学堂	深圳
一个月成为吉他高手（吉他基础速成班）	文艺生活	深圳
成人零基础粤语课，15节课包学会基础听说	沙龙学堂	深圳
玄真漂流，天溪谷探险，密室CS一日游	户外活动	深圳
彩铅的世界同样精彩――零基础彩铅画单次课	文艺生活	深圳
【线上微活动】以美呼唤自由，理想与情怀的温柔邂逅	文艺生活	深圳
单人零基础钢琴速成课	文艺生活	深圳
零基础学习陶艺，体验陶艺乐趣	DIY手作	深圳
【中秋】深圳哪里最清凉？桃花源里去溯溪	户外活动	深圳
~* 零基础教你化出完美妆容 *~	沙龙学堂	深圳
增城白水寨：登天南第一梯，亲水栈道观大瀑布	户外活动	深圳
走进吧台，DIY一杯香浓咖啡送给自己！	DIY手作	深圳
【线上微活动】 合适自己的才是最好的，找到属于自己的穿衣风格！！	派对聚会	深圳
仅需158元， 世界名曲轻松上手 ， 成就你的钢琴梦想	文艺生活	深圳
第二期：（包车包吃喝包玩）300元澳门纯玩一日游	户外活动	深圳
零基础学素描 | 用单色线条表达你的世界！	DIY手作	深圳
【形象设计必修课】穿衣打扮-色彩搭配气质提升沙龙	沙龙学堂	深圳
e网情深―科技园相亲专场	派对聚会	深圳
零基础成人钢琴 | 学会钢琴，人生不留遗憾！	文艺生活	深圳
拍一组有质感、有高级感的形象照	文艺生活	深圳
亲 这个活动更适合夏天 现在就不推荐了哈	DIY手作	深圳
【扎染】学着将一块白坯布染成自己喜欢的图案	DIY手作	深圳
乐橙岛邀你赴一次钢琴的约定	文艺生活	深圳
健身驿站周年店庆优惠月卡	运动健身	深圳
DIY纸杯蛋糕	DIY手作	深圳
父亲节跟我做――粘土DIY亲子活动	DIY手作	深圳
【一对一】钢琴曲仅售98.8元，包学会一首钢琴曲	文艺生活	深圳
女神妆容沙龙-教你快速掌握化妆技巧小秘密	沙龙学堂	深圳
【周末】漫游荷兰花卉小镇，感受异域风情	户外活动	深圳
大鹏古城+万绿野炊+杨梅坑浪漫单车	户外活动	深圳
艳遇 桂林阳朔”游漓江，西街泡吧之旅	户外活动	深圳
（端午）穿行深圳两大公园，来场赏花摄影视觉之旅	户外活动	深圳
（端午）蓝天白云的季节，跟我们一起穿越东西冲	户外活动	深圳
一起去玩跑跑卡丁车――旋转漂移，Are u ready? GO！！！	户外活动	深圳
端午节  惠东黑排角海岸线激情穿越一日游	户外活动	深圳
【国庆节】江西武功山人间仙境、天上草原徒步、观云海日出日落	户外活动	深圳
【周末】徒步盐田海滨栈道，看海、听海、玩海（1天）	户外活动	深圳
【服装设计DIY】我的私人定制美美半身裙	DIY手作	深圳
爱打壁球的人没有胖纸，这是一个人也能疯狂的运动！	运动健身	深圳
在女儿节这天，我和陶艺手工有个约会。	DIY手作	深圳
玄真勇士.彩弹巷战一日游	户外活动	深圳
超值价78元，零基础油画/画手机壳/画鞋子/画伞/画布袋	文艺生活	深圳
逆生长｜陶泥―玩出来的艺术	DIY手作	深圳
六艺「乐」---吉他的魅力	文艺生活	深圳
6.5徒步盐田最美海滨栈道，感受海风轻抚	户外活动	深圳
深圳地区红酒派对 深圳地王大厦高端酒会	派对聚会	深圳
遇见钢琴，遇见更好的自己	文艺生活	深圳
漫游观澜版画村，感受客家小村的人文气息与艺术氛围	户外活动	深圳
居合剑术体验 | 修身养心的日本剑术格斗，到底是怎么一回事？	运动健身	深圳
【服装手绘DIY】当一回时尚设计师	DIY手作	深圳
做一身儿周五时髦约会旗袍装	DIY手作	深圳
让艺术装点你的生活|零基础油画/画手机壳/画鞋子/画伞/	DIY手作	深圳
聆听身边励志瘦身分享+银湖畔万步徒步	沙龙学堂	深圳
【每天】南澳珊瑚潜水，带您探索神秘的海底世界	运动健身	深圳
当我愿意看见自己时―来一次对自己的深度心理探索	沙龙学堂	深圳
音乐学习交友聚会	派对聚会	深圳
深圳最美海岸线东西冲穿越 | 欣赏壮美海景	户外活动	深圳
从种子到杯子｜咖啡拉花体验课	沙龙学堂	深圳
陶艺乐悠悠，寻回童年时玩泥巴”的大梦想	DIY手作	深圳
I Wedding 2016新品试纱会 | 一件纯美的婚纱，一辈子的公主	文艺生活	深圳
精致女人必修课--如何管理自己的衣橱	沙龙学堂	深圳
《一个人的朝圣》心理读书会	沙龙学堂	深圳
5.21徒步盐田最美海滨栈道，感受海风轻抚	户外活动	深圳
【克服演讲恐惧】拒绝头脑空白！拒绝心跳加速！提升表达能力！	沙龙学堂	深圳
咏春| 一招一式中，感受中国传统文化之美	运动健身	深圳
网球的塑形优势，无论男女你值得拥有！	运动健身	深圳
来DIY蛋糕吧！	DIY手作	深圳
如果你不敢纹身， 那就来画海娜纹身吧！	DIY手作	深圳
等你来All in --德州扑克	派对聚会	深圳
情定喵缘--休闲趴	派对聚会	深圳
百人工匠行动 | 做一双有温度的筷子，拒绝一次性，不再吃”森林！	DIY手作	深圳
每周末深圳大鹏古城+万绿野炊+杨梅坑单车一日游	户外活动	深圳
手工木艺：以手作心，以木之名！	DIY手作	深圳
优雅仪态-魅力女性气质塑造提升之形体仪态训练	沙龙学堂	深圳
花满心时亦满楼―黄色情人节做插花	文艺生活	深圳
画画，一件文艺的小事	文艺生活	深圳
【 幸福解密】女性高级情商EQ修炼精品班	沙龙学堂	深圳
在初夏策马奔腾，共享人世繁华	运动健身	深圳
5.8马峦山踏青，赏梅亭海天一色	户外活动	深圳
强生高尔夫~体验优雅生活	运动健身	深圳
看她为你泡杯茶	茶会雅集	深圳
感恩母亲节：呵护母亲的健康，为她留下岁月的珍视！	运动健身	深圳
古筝动心弦--古筝初体验，学会两首筝曲	文艺生活	深圳
【价值80元全天攀岩票套餐仅售60元】挑战你自己的高度极限	运动健身	深圳
大鹏古城、七星湾豪华帆船体验、杨梅坑环岛骑行一日游	户外活动	深圳
手作陶艺含拉坯+捏塑+上釉+烧制1次	DIY手作	深圳
【零基础】乌克丽丽一对一课程 | 热爱音乐的你的最佳选择	文艺生活	深圳
手工皮具｜享受孤独和自由	DIY手作	深圳
【恋爱训练营】如何吸引适合你的爱人	沙龙学堂	深圳
每周末  增城单车、白水寨瀑布一天生态之旅	户外活动	深圳
我想和你虚度时光 每周六晚深圳地区最温馨派对	派对聚会	深圳
中秋/国庆  去梅州挑战五指石玻璃栈道.观世界大卧佛二日游	户外活动	深圳
九月特价来袭！清远古龙峡漂流   小北江游船一日游	户外活动	深圳
中秋节 惠州双月湾十里长滩烧烤露营2日游	户外活动	深圳
不做加班狗，五一带你去做陶艺手工	DIY手作	深圳
中秋节  英西峰林 千年瑶寨，瑶族篝火晚会二日游	户外活动	深圳
日本剑道―暖男带你零距离体验武士精神！	运动健身	深圳
用电影丈量世界，随丰乐一起去旅行	派对聚会	深圳
服装设计体验课程 | 开启一段别样的时尚之旅	DIY手作	深圳
皇太后的调教室 | 传统日式茶子之约	DIY手作	深圳
文艺小资完美体验：油画体验+插花课程+个人DV短视频制作+美图拍摄	文艺生活	深圳
5.1（深圳）穿越塘朗山，梅林水库徒步踏青	户外活动	深圳
白领减压芭蕾-释压力塑形，提升优雅气质！	运动健身	深圳
摄影展| 城市孤独者	文艺生活	深圳
清新绿色的氧气运动 | 与高尔夫球零距离接触，1小时畅快打	运动健身	深圳
姑娘，为自己缝制一件衣服吧！	DIY手作	深圳
与人跑：和心理咨询师一起跑步	运动健身	深圳
深大旁桌游 《天黑请闭眼》	派对聚会	深圳
与职业音乐人面对面，打造你的专属金曲！	文艺生活	深圳
星妈、钢琴家、作家――黄爱莲《人生&旅行&音乐分享会》	讲座沙龙	深圳
综合格斗 | 释放心中的野兽（4月16日）	运动健身	深圳
周末剑道 一起来修炼吧！	运动健身	深圳
5节主课+15节练习课，突破传统教学方法，教你弹钢琴	文艺生活	深圳
深圳单身携手深圳地王大厦空中会所狂欢Party	派对聚会	深圳
击剑有约 | 让我们像个骑士一样优雅地决斗（4月16日）	运动健身	深圳
皇太后的手作课程下午茶 | 指间的孤独星球	DIY手作	深圳
穿越半天云村，看南澳最美风景（深圳）	派对聚会	深圳
英语角|和外教老师Michael 一起学纯正的商务英语	沙龙学堂	深圳
芸集丨手工艺体验（10元就能挑一种手工活动体验）	市集	深圳
【欢乐海岸】4月3日周日深圳地区撕名牌大狂欢	派对聚会	深圳
春天啦，一起去海边画油画吧	户外活动	深圳
"每周六日  登七娘山,观地质公园博物馆一日游"	户外活动	深圳
深大环线B728乐队带你提高唱功	文艺生活	深圳
那些走在我们前面的人｜元培电影放映第四期	派对聚会	深圳
周末DIY烘焙，一起来这里	DIY手作	深圳
惠州博罗那里花开”公园，罗浮山实弹射击，古村落摄影	户外活动	深圳
（每周六、日）惠东黑排角、看怪石、观骇浪、原生态海岸线穿越一日游	户外活动	深圳
徒步盐田最美海滨栈道，感受海风轻抚	户外活动	深圳
墨门书院 | CAT演讲大会 ―初心”	讲座沙龙	深圳
天音人语――琴箫诗词吟诵（读给春天的诗）	暂不开放	深圳
做一条美美的大摆裙 - 周末的缝纫时光	DIY手作	深圳
手工兴趣班~零基础，欧式刺绣兴趣班	DIY	深圳
大鹏古城、杨梅坑环海单车一日游	户外活动	深圳
把春天带进家里 | 花艺-家居瓶花	体验课	深圳
油画聚会画画活动――来认识更多喜欢画画的朋友吧	文艺生活	深圳
只需一节课 就可以成为绘画高手？零基础也可以？	文艺生活	深圳
缤纷”――David Gerstein雕塑艺术展	展览	深圳
密室里的伟大母性｜影讯：伦尼・阿伯拉罕森《房间》	电影	深圳
电影戏剧表演	派对聚会	深圳
芝士多多的意大利披萨自己做	DIY手作	深圳
连平桃花山之旅	户外活动	深圳
每个人都可以是设计师――服装/手工/体验课/聚会	DIY	深圳
【3.11】英国顶级爵士歌手Ian Shaw四重奏 2016年亚洲巡回及专辑发布	音乐会	深圳
深圳博物馆《琉光璃彩――欧洲玻璃艺术史珍品展》	展览	深圳
端午节  中国最美八大海岸线之东西冲穿越一日游	户外活动	深圳
告别匆忙，慢享小别墅的精致下午茶	文艺生活	深圳
万绿野炊+摘草莓+杨梅坑浪漫单车一日游+深圳本土美丽乡村油菜花	户外活动	深圳
美丽乡村油菜花、樱花+万绿野炊+摘草莓+杨梅坑浪漫单车一日游	户外活动	深圳
每周末广州最美乡村从化影古线竹林徒步	户外活动	深圳
绿素瑜伽 超值体验	运动健身	深圳
原形本体――椭圆界：松尾光伸个展	展览	深圳
向阳花老师拉片带你看《大鱼》	电影	深圳
欢乐海岸撕铭牌交友聚会	运动健身	深圳
紧张，刺激，脸红，羞羞哒！周末狼人杀桌游活动！	派对聚会	深圳
去深圳最美海岸线东西冲穿越・欣赏壮美海景	户外活动	深圳
国际瑜伽大师Duncan Wong来啦！带你走进瑜伽理疗新世界！	运动健身	深圳
周末狼人杀，东门乐聚TOYBOX	派对聚会	深圳
然舍手作 丨手作植物押花书签	体验课	深圳
感念亲情｜元培电影放映第三期	电影	深圳
减肥这件事情从来没有大结局”，直到遇上......	派对聚会	深圳
哈施塔特-奥地利小镇异域风情 怡情谷温泉一天游	户外活动	深圳
深圳颜值担当丨手作植物押花相框	体验课	深圳
成人学钢琴，2节课学会弹奏3首歌，结交一群好友！20元抢购体验！	文艺生活	深圳
跟10位帅哥老师学钢琴，3首钢琴曲/2节课/27元限时体验！	文艺生活	深圳
【2016春节】相约海南三亚、非诚勿扰	户外活动	深圳
春季祝福｜能量塔罗个案”	定制方案	深圳
【o念情感】―恋爱公开课（线下分享会）	派对聚会	深圳
西语下午茶--（海外生活）Viviendo en el extranjero	体验课	深圳
春联DIY篇	体验课	深圳
【11月19日周六晚】 单身男女狂欢趴踢 | 一起渡过周末闲暇的时光	派对聚会	深圳
周四 Salsa 派对！Thursday Salsa Party	派对聚会	深圳
来做一枚安静画画的美（男）女子	文艺生活	深圳
成人钢琴零基础，两首曲子包教会	文艺生活	深圳
贵族运动体验 感受剑尖上的优雅	体验课	深圳
花禅丨艺术家的声音	展览	深圳
素人拉丁乐团鼓舞会友”	派对聚会	深圳
重返80‘s 的Party	派对聚会	深圳
你笑的时候，最美	展览	深圳
六艺「射箭」――带你体验百步穿杨	运动健身	深圳
变幻双色曲奇定制DIY	DIY	深圳
石头家    1/17-深圳荒野书屋    陈成辉说着弹着音乐作品分享会	派对聚会	深圳
墨门书院六艺【书】：心动――文案创作	讲座沙龙	深圳
"深圳第二峰七娘山穿越,揭秘七娘山神秘面纱"	户外活动	深圳
Coachellhat party【摇滚+电音派对】	派对聚会	深圳
元旦归来，多肉与鲜花	体验课	深圳
深圳大鹏古城+万绿野炊+杨梅坑浪漫单车一日游	户外活动	深圳
深圳最美海岸线东西冲穿越-欣赏壮美海景	户外活动	深圳
生活茶艺―静心 | 体验课	茶会雅集	深圳
深圳明剑馆剑道体验	运动健身	深圳
零基础成人钢琴课程，一对一教学；热爱我的钢琴	文艺生活	深圳
动手做一杯属于自己的咖啡	体验课	深圳
「墨言」墨门书院2016年度文化盛会	讲座沙龙	深圳
去高大上的前海企业公馆体验高精尖的虚拟现实游戏	体验课	深圳
【狂欢派对】深圳地区每周六晚狂欢派对	派对聚会	深圳
2015/12/27 爵士女声LE?LA MARTIAL @Baa Box	音乐会	深圳
初学者零基础绘画｜素描、彩铅、水彩	体验课	深圳
单身进| 天黑请闭眼/真心话大冒险/谁是卧底/杀人游戏大召集	派对聚会	深圳
奇幻唯美世界	展览	深圳
【乐尚琴吧】专业成人钢琴套餐	文艺生活	深圳
做条舒适百搭的插袋短裤吧 - 周末的缝纫时光	DIY手作	深圳
每周日欢乐海岸Couple 大作战约定你	派对聚会	深圳
"『聚石青年文化社』-\""与艺术的初次见面\"""	派对聚会	深圳
尤克里里、吉他、非洲鼓免费体验课	体验课	深圳
杂咖咖啡学堂	体验课	深圳
心理评估：你离真相只差50分钟	沙龙学堂	深圳
白领减压，在国标与拉丁中尽情释放优雅和激情！	运动健身	深圳
百步穿杨-带你体验箭无虚发	运动健身	深圳
【超值体验】盈利嘉高尔夫体验中心	运动健身	深圳
「特别企划」欢乐海岸每周日深圳地区撕名牌大狂欢	派对聚会	深圳
在冬天来临之际，学会织围巾	派对聚会	深圳
中国首家城央人文艺术馆|体验时尚生活新场域	派对聚会	深圳
橡皮章上的中字	DIY	深圳
让我们来染色吧：草木扎染体验	派对聚会	深圳
天冷了，暖暖?吧~心理成长小组招募（最后1位，男士更好）	讲座沙龙	深圳
最经典海岸线-东西冲穿越	户外活动	深圳
晓石画话―艺术史沙龙《自由、具体的心灵――浪漫主义艺术》	讲座沙龙	深圳
浪漫礼物： 手工DIY制作浓情巧克力	DIY手作	深圳
关于黄瑶古镇的事，讲给最爱的人听	运动健身	深圳
【男士形象指导】美女搭配师教你怎么穿！	体验课	深圳
动手做月饼一起过中秋	派对聚会	深圳
抗战老兵系列纪录片全国公益展映及导演交流会之深圳站	展览	深圳
科幻沙龙之人工智能	派对聚会	深圳
天音人语――琴箫诗词吟诵（中秋专场）	暂不开放	深圳
【特惠课程】周末学点啥？尤克里里、吉他、非洲鼓任你选~	讲座沙龙	深圳
心灵沙龙：婚恋关系及幸福感的心灵奥秘	讲座沙龙	深圳
遇见就在「哈施塔特」：奥地利小镇异域风情，怡情谷温泉摄影之旅	户外活动	深圳
墨门书院品酒会第②期：葡萄美酒夜光杯	讲座沙龙	深圳
惬意周末 | U COFFEE咖啡达人体验	体验课	深圳
寻找投射在银幕上，你梦想中的你：一起造梦，玩转微电影体验课！	派对聚会	深圳
【小聚场创意烘焙】芒果慕斯DIY制作	DIY手作	深圳
「此刻 The Moment」为爱情写一首诗	派对聚会	深圳
下班后来画画	派对聚会	深圳
【降】价特惠：成人钢琴29元3首歌 2节课 免费练琴两周	文艺生活	深圳
一个下午Ukulele学会弹唱	派对聚会	深圳
「Brain On A Sofa」意大利爵士大师 | 萨克斯独奏音乐会	暂不开放	深圳
HOW TO COUNT ONE TO TEN 中国巡演	暂不开放	深圳
波兰摇滚教父 The Warsaw Booms 2015 中国巡演	暂不开放	深圳
立式画架，手执画笔 | 0基础素描初级1元体验课	讲座沙龙	深圳
抛开城市的喧嚣，相约神秘三门岛，浪漫露营海边烧烤吧	运动健身	深圳
理想青年的呓语，后摇与硬核的交媾！	暂不开放	深圳
瓷爱谷陶艺周末，走进「人鬼情未了」的泥巴世界	派对聚会	深圳
如何穿着有型――搭配师给你量身搭配	文艺生活	深圳
「此刻 The Moment」前世今生回溯疗法	派对聚会	深圳
心灵体检：我该何去何从？	派对聚会	深圳
枪击泼辣 & Trash 世界尽头的末班车” 中国巡演―深圳站	暂不开放	深圳
周末怎么玩？陶艺喊你来	DIY	深圳
这也是一场小型音乐会！音乐，永不停息「音乐沙龙第6期」	派对聚会	深圳
月圆中秋 小聚场邀你一起手作冰皮月饼	DIY手作	深圳
9月25日周日晚 | 地王顶楼深圳地区联谊酒会 蛋糕品尝+星空许愿	派对聚会	深圳
我们匆匆赶来，只为给您拍照|上门服务、全天跟拍，还免费哦	派对聚会	深圳
怦然心动 深圳地区最靠谱相亲交友聚会	派对聚会	深圳
不是中秋不能买月饼？冰皮月饼自己做！	派对聚会	深圳
晓石画话：艺术史沙龙「巴洛克在法国」	派对聚会	深圳
少女情怀总是诗・周六晚宅男宅女周末趴	派对聚会	深圳
青春没有终点，深圳红糖罐	暂不开放	深圳
15元爱心瑜伽，让身心一起律动	运动健身	深圳
车公庙画室狼人杀	派对聚会	深圳
带着你的Ta，一起来风车岛沐浴阳光，享受沙滩！	派对聚会	深圳
周末，我们一起约看场日影吧	电影	深圳
【变身烘焙达人】DIY女神版浪漫樱花芝士蛋糕	DIY手作	深圳
晓石画话：艺术史「从西班牙到荷兰的巴洛克」	派对聚会	深圳
意指手艺学堂：我和三伏天有个皮具之约	派对聚会	深圳
听听别人的创业经验：一个不懂公益的品牌顾问，是做不好互联网产品的！	派对聚会	深圳
姑娘，来做衣服啦！	派对聚会	深圳
We Want U：技能大交换+国王游戏	派对聚会	深圳
你还好吗？来一场心理评估	派对聚会	深圳
低价格看高逼格话剧「爱・情排练厅」	派对聚会	深圳
【299如此疯玩1天】引领时尚生活新风向，七星湾豪华帆船体验	运动健身	深圳
这个夏天抛开城市的喧嚣，相约神秘三门岛浪漫露营海边烧烤吧	派对聚会	深圳
南澳珊瑚礁潜水，带你走入神秘的海底世界 第6弹！	运动健身	深圳
带上亲爱的Ta，一起穿梭时空漂流河道 探秘远古侏罗纪时代吧	派对聚会	深圳
专属你的电影院，畅看你想看的电影	派对聚会	深圳
听一场小型演唱会，何康吉他演奏音乐会	暂不开放	深圳
晓石画话：艺术史「意大利到西班牙的巴洛克」	派对聚会	深圳
【红娘】8分钟遇见 两人搭起美丽新世界	派对聚会	深圳
周末烘焙达人时间 :手把手教你DIY颜值高高的杯子蛋糕	DIY手作	深圳
听听别人的音乐故事：独立音乐人高宇婧の音乐是我不会变的朋友	派对聚会	深圳
南澳珊瑚礁潜水，带您走入神秘的海底世界	运动健身	深圳
周末的缝纫时光，做一件衣服..........	派对聚会	深圳
学会两首钢琴曲，用指尖触动心灵	文艺生活	深圳
【指尖传情】49.9教会2首歌圆你1个钢琴梦	文艺生活	深圳
一对一指导，陶艺体验，自己做彩绘	派对聚会	深圳
离天空最近的音乐会	暂不开放	深圳
天音人语：琴箫诗词吟诵	暂不开放	深圳
十二星座攻心策路 深圳地区十二星座大聚会	派对聚会	深圳
我要在你平庸无奇的回忆里，做一个闪闪发光的神经病	派对聚会	深圳
穿越漫山竹林，漫步古老的村落	茶会雅集	深圳
许我一个瑜伽，还你一个健康。	运动健身	深圳
蛋糕这么性感，怪我咯怪我咯 ・ 蛋糕4选1DIY	派对聚会	深圳
零基础油画：让时光在笔尖流淌	派对聚会	深圳
白领减压话剧训练班，一起疯一起玩一起成长！	派对聚会	深圳
夏日活动：学会一门乐器之Ukulele	暂不开放	深圳
白领减压芭蕾形体，释放压力，锻炼挺拔形体，提升优雅气质，重塑新生！	文艺生活	深圳
保证教会3首钢琴曲，激扬你的音乐梦想	文艺生活	深圳
【一对一形象指导】高级服装搭配技巧	派对聚会	深圳
旧衣也是个宝 | 壹刻栈mini空间之旧衣改造	派对聚会	深圳
现在开始剑道之路！在这个酷暑，来体验一把激昂的剑道！	运动健身	深圳
深圳最後的世外桃花源桔钓沙穿越	运动健身	深圳
一起谈谈创业梦，也许你就是下个CEO	派对聚会	深圳
帮你「提高心理的熵」，一对一专业心理评估	派对聚会	深圳
探访百年客家古村落 体验现代版画之美 ---摄影微旅行之观澜版画村	文艺生活	深圳
公益讲座｜知茶	文艺生活	深圳
万丈崖探险 | 清远古龙峡漂流，北江小三峡	运动健身	深圳
公益讲座｜禅绕・艺术疗愈	文艺生活	深圳
饼干上的创意裱花 ・ 公仔曲奇饼干DIY	派对聚会	深圳
小假期，不如去学个吉他	派对聚会	深圳
神秘的曼丁节奏，震撼的打击乐	派对聚会	深圳
慵懒的午后，弹弹Ukulele唱唱歌	派对聚会	深圳
度个娴静时光 | 玩玩粘土喝喝咖啡	DIY手作	深圳
品时光的味蕾 ・ 葡萄牙王室御用红酒鉴赏	派对聚会	深圳
《水云》-国内首张ukulele指弹专辑巡演	暂不开放	深圳
你也是小小的陶艺手 ・ 陶艺全过程体验	派对聚会	深圳
给自己做件美美的衣裳，就在这个夏天	派对聚会	深圳
微缩景观DIY---把小花园带回家	派对聚会	深圳
打开一扇占星之门，带你走进占星殿堂|听著名占星师来讲解	派对聚会	深圳
「女神季」找到你适合的着装色彩与风格！	文艺生活	深圳
【还不奔跑？】5km荧光夜跑 ・ 相约深圳湾畔	派对聚会	深圳
将小资进行到底 | 30分钟双手弹奏一首钢琴曲，当咖啡遇见钢琴	文艺生活	深圳
来，做你的Muffin cake！	派对聚会	深圳
【爱情专车来接送】1个人怎会孤单，一起邂逅爱情巽寮湾	派对聚会	深圳
打鼓永远是件快乐的事，每周五晚非洲鼓公开课	派对聚会	深圳
1元街舞课 | 将舞动进行到底！优惠不分年龄与性别！	运动健身	深圳
徒步最美乡村 | 溪头村竹林摄影，摘杨梅休闲一日游	运动健身	深圳
禅绕画 ・ 让头脑也来做做瑜伽吧	派对聚会	深圳
1元体验周日4小时的吉他课	派对聚会	深圳
ukulele1元钱体验4小时，学弹唱学指弹啦~	派对聚会	深圳
热浪来袭！台湾乌克丽丽阿浪老师，阿吉老师大陆巡回讲座表演！	暂不开放	深圳
这个盆栽你吃吗？ ・ 盆栽蛋糕DIY	派对聚会	深圳
白领减压话剧训练班，一起疯，一起玩，一起成长！	戏剧	深圳
茶熏瑜伽舍招生	运动健身	沈阳
中秋节火车团邀你同游最美长白山瑶池仙境-魔界-三角龙湾3日游	户外活动	沈阳
从零基础带你领略油画世界的魅力	沙龙学堂	沈阳
大师教你学钢琴   快速晋级钢琴大咖	文艺生活	沈阳
零基础油画体验课 Healing自由室 只为在这里 遇见最初的你??	文艺生活	沈阳
悠澜生活插花体验	DIY手作	沈阳
不限时・悠闲学画画	DIY	沈阳
99元高尔夫：赠球杆+手套+教学+100颗击球	运动健身	沈阳
实用旅游英语讲座沙龙	讲座沙龙	沈阳
一间能画画的咖啡屋-喝杯咖啡，画幅画儿	派对聚会	沈阳
正确认识心理学	讲座沙龙	沈阳
优雅运动高尔夫之旅 赠球杆+手套+30分钟教学+100颗击球	运动健身	沈阳
画一幅钟爱的油画，送给最爱的人	派对聚会	沈阳
两节课，学会三首钢琴曲	文艺生活	沈阳
月圆之夜狼来了 「狼人杀」玩家招募	派对聚会	沈阳
享你所想 ・ 爱桌游 | S18盛夏避暑趴之烧脑桌游趴	派对聚会	沈阳
用画笔追溯你青春的痕迹，一个24小时对你开放的油画空间	派对聚会	沈阳
享你所想 ・ 爱电影 | 电影沙龙活动「千钧一发GATTACA」	电影	沈阳
DIY自己的艺术陶瓷｜陶艺体验	派对聚会	沈阳
一个一辈子只能玩一次的游戏 你敢挑战吗？	派对聚会	沈阳
书法课程开班通知	体验课	石家庄
一杯酒，交一个班的朋友「葡萄酒红酒品酒师初级课」	户外活动	苏州
布艺入门 | 复古又时尚的口金包正在流行	DIY手作	苏州
发现更美丽的自己，手把手教你化淡妆	沙龙学堂	苏州
大师教你学钢琴 ，  快速晋级钢琴大咖	文艺生活	苏州
仅售158元 ，世界名曲轻松上手，  成就你的钢琴梦想	文艺生活	苏州
「初级品酒师体验课」赠定制海马刀一把	户外活动	苏州
苏州直升机空中游览，鸟瞰不一样的姑苏美景	户外活动	苏州
自制一管唇膏，自然润泽无添加，呵护自己 爱他	DIY	苏州
TRX・全身抗阻力训练，感受挥汗如雨的畅快感觉	运动健身	苏州
咖啡DIY，陪你过夜的咖啡最长情	DIY手作	苏州
给自己的春日礼物――diy创意毛衣链	DIY	苏州
心灵探索之旅：解梦，听见内心的声音。	派对聚会	苏州
发现更美的自己，手把手教你化美妆！	讲座沙龙	苏州
想不想为自己调制一款专属香水？	DIY	苏州
每周一起学画画！素描、油画、水彩、彩铅、书法、国画！	派对聚会	苏州
赵鹏 行吟” 全国巡回歌友欣赏会 苏州山丘	暂不开放	苏州
【星宇画室】油画季之新年家居装饰画	派对聚会	苏州
不忘初心――古风水印情书	派对聚会	苏州
高智商人的游戏----幻域真人密室逃脱	派对聚会	苏州
【花艺DIY】花艺手作  搭配下午茶哦	DIY手作	天津
大师教你学钢琴 ，   快速晋级钢琴大咖	文艺生活	天津
日本剑道体验！	运动健身	天津
天气这么热，宝宝要去水里high，过一个清凉的夏天了！！！	运动健身	天津
仅售158元，世界名曲轻松上手  成就你的钢琴梦想	文艺生活	天津
【GoART】6月26日零基础绘画《埃菲尔花香》	文艺生活	天津
和歪果仁侃大山｜英语学习	沙龙学堂	天津
周六来大悦城学做英伦下午茶必备的【脆皮泡芙】吧！	DIY手作	天津
丽人节，如此嗨，你可愿参加？	派对聚会	天津
第二期人际关系成长小组	讲座沙龙	天津
阅读是一种态度	讲座沙龙	天津
古茶丽影	体验课	天津
跟陈晨老师到天博看「晚明绘画展」	讲座沙龙	天津
周末房故事－天津风貌建筑与名人故居－金彭育”10次课程	户外活动	天津
＃知在影院＃ 实习生	电影	天津
2月27日，新加坡手网烘焙大师田老师来啡学院了！	讲座沙龙	天津
【花艺DIY】借时光之手 暖一束花开	派对聚会	天津
新年第一波【围巾扎染】活动开始报名啦	DIY	天津
古典芭蕾舞成人零基础体验活动	文艺生活	天津
冬季葡萄酒品鉴会	讲座沙龙	天津
一花一世界，一叶一菩提，来体验一下奇妙的「插花」世界吧	派对聚会	天津
油画装点生活	DIY	天津
扎染初体验：一块来自秋天的手帕	派对聚会	天津
插花体验活动：插一束春风清韵，赋花予你意	派对聚会	天津
水彩的斑斓世界	派对聚会	天津
宜兴：追溯最原始的茶叶秘密，与窑厂穿越明清	茶会雅集	无锡
生活茶艺课程	体验课	无锡
无锡雪浪山漂流 ，雪浪山周边人杰地灵，人文荟萃	派对聚会	无锡
成人零基础彩铅手绘	文艺生活	武汉
做一个更精致的女神！【45分钟钢琴课10元体验】	文艺生活	武汉
素彩青橙绘画艺术空间(DIY零基础油画)	DIY手作	武汉
2016万圣节重磅活动魔女惊魂主题惊悚派对（汉口站）| 众魔狂欢・颜值逆天	派对聚会	武汉
最好的礼物，莫过于我想给你最好的。（DIY饼干）	DIY手作	武汉
《会痛的不是爱》-知见心理学读书会	沙龙学堂	武汉
成人钢琴【18课时】深度体验，遇见最美好的自己【188元抢购】！	文艺生活	武汉
用不贵的钱来享受贵族般儒雅的射箭运动――零基础射箭私享课	运动健身	武汉
【25元精致体验】2节课学会弹奏3首钢琴曲，结交一群好友！	文艺生活	武汉
岚道场拳击体验课 | 勇敢者的运动，释放你内心的野兽力量	运动健身	武汉
送你一瓶酒，听你讲故事	文艺生活	武汉
海螺拾绘馆 ----毛毡（入门篇）	文艺生活	武汉
亲手做健康的月饼送给家人吧！	DIY手作	武汉
【零基础学水彩】不再做艺术看客，用画笔绘出人生旅途	沙龙学堂	武汉
海螺拾绘馆------套娃订制	DIY手作	武汉
不一样的假期：户外烧烤+野外露营+真人CS	户外活动	武汉
教授唱歌技巧+KTV实战！	文艺生活	武汉
仅售158元 ，世界名曲轻松上手  成就你的钢琴梦想	文艺生活	武汉
海螺拾绘馆 ----毛毡（难度篇）	DIY手作	武汉
【零基础学油画】笔尖勾勒美好时光，轻松体验艺术生活	沙龙学堂	武汉
DIY满天星花球，少女情怀，举手投足都是诗	DIY手作	武汉
三次公开体验课 |跳salsa--最in最时尚的生活方式！	文艺生活	武汉
录制歌曲 | 留下美好声音	文艺生活	武汉
海螺拾绘馆-----陶泥（入门篇）	DIY手作	武汉
手绘古风团扇 水彩花卉 复古创意绘画	DIY手作	武汉
【期遇记.手绘包】手绘文艺帆布包，画画关于这个夏天的文艺小清新	DIY手作	武汉
[PainterGo]零基础约画清新画作《夏季如诗》95元送33元以内饮品哦！	文艺生活	武汉
舞蹈和瑜伽相遇，不一样的身体感觉！	运动健身	武汉
零基础油画沙龙，夏日清新油画大赏	文艺生活	武汉
翻身向天仰射云	运动健身	武汉
DIY羊毛毡饰品，可爱到爆！	DIY手作	武汉
3.3折，招募心理咨询来访者	沙龙学堂	武汉
6.4独立新民谣音乐唱作人 马融 赤脚的孤儿 全国巡演	暂不开放	武汉
创意手绘石头・画出来的石头艺术	DIY手作	武汉
美丽如你期待，手工原创珠宝沙龙集结号	DIY手作	武汉
diy水晶球梦幻Mini小屋（可两人同时体验）	DIY手作	武汉
零基础水彩画美术体验课・水彩笔尖晕出的花儿	文艺生活	武汉
专业成人钢琴18节课198元 一对一上课	文艺生活	武汉
【知见心理学沙龙】  让爱不留遗憾-亲密关系调解	沙龙学堂	武汉
愚人节说我爱你”――4.1外滩高端交友派对	派对聚会	武汉
陶艺之美|釉上彩	DIY手作	武汉
【3月6日】挑战自己，畅快体验，道观河桥降+岩降+烧烤	户外活动	武汉
感受一把快意攀岩的乐趣	运动健身	武汉
专业零基础绘画教室	讲座沙龙	武汉
武汉最时尚派对｜每周二万丽酒吧Salsa Party	派对聚会	武汉
零基础画油画 交友	体验课	武汉
布艺课堂 免费公开课  与钥匙扣来个指尖上的约会～	派对聚会	武汉
北翼归巢	暂不开放	武汉
悠扬琴声开启你的音乐人生之旅	派对聚会	武汉
把记忆中的世界浓缩在小瓶子里，创意微景观DIY，一起来体验吧！	派对聚会	武汉
「剑」在型 「道」在内	运动健身	武汉
最纯粹的艺术【禅心书法】	讲座沙龙	武汉
【五日暖心烘焙班】1月18日！15品种包教会包吃包晒美~	DIY	武汉
度一个软萌萌的午后时光，软陶创意手作~	派对聚会	武汉
明逸书院零基础禅心书法营	讲座沙龙	武汉
燃！在这个秋季来体验一把异国风情的剑道！~	体验课	武汉
【零基础学微木工|做出属于你的匠心独运”个性吊坠】	DIY	武汉
甜蜜蜜，亲手做一份巧克力给TA~	DIY	武汉
【汉口、武昌  吉他&尤克里里公开课】周三至周日每天都有！	文艺生活	武汉
一朝一绘――「成人零基础」油画活动	派对聚会	武汉
小小植物景观微世界，打造你的秘密花园	派对聚会	武汉
「2小时单人畅玩套餐」软陶DIY，大把萌物带回家~	派对聚会	武汉
自我形象设计(冬日浪漫季) | 打造约会妆容！	沙龙学堂	武汉
咖啡拉花兴趣班~~【学者精品咖啡体验沙龙】	派对聚会	武汉
为心中所爱画一套书签吧	派对聚会	武汉
信不信陶泥能捏出一切，来彼岸「软陶DIY」吧	派对聚会	武汉
零基础学木工，做出属于你的个性魔戒~	派对聚会	武汉
爱上彩虹，吃定彩虹！萌萌哒彩虹推推乐蛋糕~	DIY	武汉
意式咖啡制作体验 | 自己制作出漂亮的拉花咖啡	文艺生活	西安
花式手工皂零基础课堂	DIY手作	西安
DIY下午茶（自制咖啡＆苏打水）| 享受高颜值下午茶，满满都是好心情	文艺生活	西安
Wine Class Entry Level	沙龙学堂	西安
童话故事中经典的玫瑰形象你认识几个？	DIY手作	西安
周末与茶相约 | 了解茶中学问，学习茶艺冲泡技巧	茶会雅集	西安
逸尚钢琴成人钢琴课程零基础入门班	文艺生活	西安
【泥巴创客空间工作坊】PS表情包大战！	沙龙学堂	西安
CityWalk城市徒步：夜骑大明宫，穿越到当年今日的唐朝皇宫	运动健身	西安
【疯狂周末】真人CS，来组队吧！	户外活动	西安
定制一把芭蕉扇 ，煽屎臭猴子！！	DIY手作	西安
亲手做一杯醇香的咖啡，享受午后好时光	DIY手作	西安
穿上马赛克外套的浪漫烛台 | 一份独一无二的礼物	DIY手作	西安
拿色炼咒 印度人体手绘 半永久纹身	文艺生活	西安
仅售158元， 世界名曲轻松上手 ， 成就你的钢琴梦想	文艺生活	西安
【极星山水★休闲团】6.5 周日 平河梁（安静美丽的大草甸）	户外活动	西安
周末疯狂撕名牌大战	派对聚会	西安
紫云女红课堂---可爱实用口金包	DIY手作	西安
曼荼罗剧场 一人一故事，说说你的爱情	讲座沙龙	西安
【缘来如此】周二?陶艺趴	DIY手作	西安
禅韵琴社体验课	文艺生活	西安
少年攀岩培训	运动健身	西安
一杯咖啡换一本书，交一个朋友！	派对聚会	西安
大华1935百人撕名牌大战	派对聚会	西安
逸尚古筝课程 成人零基础入门班	文艺生活	西安
【极星山水★休闲穿越】4.9 周六 塔峪―楼子山―田峪	户外活动	西安
腹有诗书气自华---周五读书会活动	讲座沙龙	西安
一片叶，一杯茶――申时茶约	茶会雅集	西安
桌上艺术----每周六桌游聚会	派对聚会	西安
【每周一】网球力量，等你来挑战	运动健身	西安
艺术影聚 | 城墙影院之你看透了我的心	电影	西安
CityWalk城市原味徒步：西仓老集市	户外活动	西安
您身边的私人健身教练---HP私教工作室	运动健身	西安
西安香道初级培训班	沙龙学堂	西安
体验最接近中国古典插花风格的小原流花道	体验课	西安
从零开始葡萄酒入门课	体验课	西安
【西安】CityWalk：长安书香路	户外活动	西安
国粹：传统弓箭兴趣体验班 学习班	运动健身	西安
我们来折纸|当一张纸有了生命	DIY	西安
灵动的沙--从指尖流出来的艺术	DIY手作	西安
新年到，木刻大圣，印红包喽	派对聚会	西安
文艺青年每周一聚	暂不开放	西安
小王子的B-612的小星球	文艺生活	西安
花与朵|感动由你――棉花手束制作课	DIY手作	西安
以刀为笔，木刻版画体验	DIY手作	西安
日本小原流花道课程体验课	体验课	西安
赴一场白葡萄酒的冬日约会	派对聚会	西安
巧说?善听――沟通中的察觉[一][二]|麦子心理学课堂	讲座沙龙	西安
想当穷爸爸还是富爸爸？|现金流桌游体验沙龙	讲座沙龙	西安
熊孩子捣鬼万圣节化妆派对	派对聚会	西安
成功是道选择题：「人生规划」主题分享沙龙	讲座沙龙	西安
「Elenore乐队」首张专辑《马戏团的国王》全国巡演―西安	暂不开放	西安
伯克利学院 Sun BeatzZ 乐队 2015 中国巡演 西安光圈	暂不开放	西安
七夕特约 | 过节传统，浓情巧克力DIY	派对聚会	西安
戳出来的羊毛毡挂件，萌得你一脸血~！	派对聚会	西安
烘焙课 | 把情绪通通吃光！	DIY手作	西安
减压新方式，熊孩子枕头大战主题派对！	派对聚会	西安
DIY手工织布机：让我们一起玩毛线！	DIY手作	西安
烘焙课 | 夏日少女心基础 cupcake@婕妮花咖啡馆	DIY手作	西安
「爱就要一辈子」纯银・情侣对戒DIY	派对聚会	西安
油画下午茶，享受艺术生活。	派对聚会	西安
【趣游・房车】住1晚途居扬州国际露营地房车，游营地公园，住房车，数星星，享受不一样的新颖假期	户外活动	扬州
福建东山岛潜水，身临美丽的海洋世界	户外活动	漳州
99元・高尔夫特惠之旅：赠球杆+手套+教学+100颗击球	运动健身	长春
成人零基础速成钢琴 | 1个月不限时间和课时学会5首钢琴曲	文艺生活	长沙
大师教你学钢琴      快速晋级钢琴大咖	文艺生活	长沙
蜡手像制作	DIY手作	长沙
仅售158元 ， 世界名曲轻松上手 ， 成就你的钢琴梦想	文艺生活	长沙
用花点亮美好的生活 （手工花制作）	DIY手作	长沙
陶艺杯子DIY	DIY手作	长沙
一起来学手工刺绣吧！！	DIY	长沙
怀旧音乐现场之 五月天&周杰伦	音乐会	长沙
做自己情绪的主人	讲座沙龙	长沙
手工香皂 DIY 制作体验	DIY手作	长沙
陶艺制作（制陶、修坯、上釉、烧制）	DIY手作	长沙
遇见瑜伽生活馆【茶艺】兴趣班开课	茶会雅集	长沙
夏不为利・五星级酒店大抢购	派对聚会	肇庆
琴茶莲语 | 观心自在  品普洱茶，茶有茶道、琴有琴道	茶会雅集	郑州
你真的了解自己？团体心理沙盘，初体验	沙龙学堂	郑州
成人零基础学琴零压力，30分钟完成梦想	文艺生活	郑州
免费服装设计体验课	DIY手作	郑州
Espresso与牛奶的完美邂逅，只为喝杯好咖啡	DIY手作	郑州
成人零基础油画临摹丨《麦田里的丝柏树》	户外活动	郑州
成人零基础油画	户外活动	郑州
莫道茶事2016年茶学精修班	茶会雅集	郑州
「莫道茶事」小茶才露尖尖角 ・ 新春品鉴会 预告	茶会雅集	郑州
春山问茶：十三亦”春季游学	户外活动	郑州
春茶出来了，老张邀你一起回家做茶啦！	派对聚会	郑州
玩银密约――戒指体验课	DIY手作	郑州
氨基酸洁面慕斯DIY	体验课	郑州
倾听你的故事	派对聚会	郑州
ME私人影院	派对聚会	郑州
【HI FLOWER七夕第二章】快递小哥都会写情诗了，你呢？	派对聚会	郑州
从今天起，做个美貌与厨艺并存的人	派对聚会	郑州
【HI FLOWER七夕第一章】教你比烂俗的我爱你” 更戳心的表白	派对聚会	郑州
Hi-Learning英文沙龙	派对聚会	郑州
零基础花艺兴趣沙龙	DIY手作	重庆
心理健康＆塔罗牌占卜 | 我期待你是勇敢和真实的	沙龙学堂	重庆
素坯彩绘盘子或者杯子+创意手工勺子套餐+上釉+烧制（二选一）	户外活动	重庆
亲手做一份真诚的礼物送给她~	DIY手作	重庆
左邻右舍 | 阿古的国画课堂：笔随意走，墨由心出	文艺生活	重庆
左邻右舍 | 书法教室：彩笺尺素，且与君书	文艺生活	重庆
运动你的手指，奔跑单线条艺术，铁丝艺术体验！	DIY手作	重庆
浅浅时光里品一杯精品咖啡	文艺生活	重庆
爱的智慧”――炼金师心理健康课程	沙龙学堂	重庆
玩转不织布”DIY手工活动	DIY手作	重庆
通过塔罗牌了解未来以及你自己	沙龙学堂	重庆
做一杯属于自己的咖啡	沙龙学堂	重庆
【用钢琴重拾梦想】大师教你学钢琴  快速晋级钢琴大咖	文艺生活	重庆
优雅清凉――跟着大师学蜀绣	DIY手作	重庆
达人教你来做蛋黄酥”	DIY手作	重庆
陶艺拉坯体验	DIY手作	重庆
【Ruby酒屋--分享会】印度洋上的佛祖泪”	沙龙学堂	重庆
左邻右舍 | 僵尸游戏：人类和僵尸斗智斗勇	派对聚会	重庆
塔罗灵疗――超心理艺术养生法	沙龙学堂	重庆
仅售158元， 世界名曲轻松上手， 成就你的钢琴梦想	文艺生活	重庆
陶艺拉坯体验・泥塑体验套餐	DIY手作	重庆
【重庆】CityWalk ：逝去的老重庆―百年沧桑南滨路	户外活动	重庆
陶艺课程之微物制作	DIY手作	重庆
陶艺手工DIY原创猫碗”	DIY手作	重庆
喝西班牙啤酒，看欧洲杯直播	派对聚会	重庆
【重庆】CityWalk：逝去的老重庆―鹅岭・李子坝	户外活动	重庆
【优惠中】攀岩体验，免费培训	运动健身	重庆
【迷恋古典】爱上piano，古典钢琴1对1授课	文艺生活	重庆
【懒人定制】六月专场 | 木作一个承载意义的时钟	DIY手作	重庆
【玛雅文明・图腾印记・古老智慧】探索	沙龙学堂	重庆
陶艺花瓶---DIY手工陶艺空间	DIY手作	重庆
红酒分享会| 邂逅法国波尔多	文艺生活	重庆
皮艺体验零钱包DIY制作	DIY手作	重庆
优雅高尔夫：赠球杆+手套+教学+100颗击球	运动健身	重庆
品鉴香醇咖啡，享受舒适下午	沙龙学堂	重庆
水晶之爱-集体塔罗牌占卜	沙龙学堂	重庆
武夷情：私家深度茶旅行，带你绽放在武夷山水	茶会雅集	重庆
一个胸针”陪你进入春天	DIY手作	重庆
左邻右舍 | 右翼带你PS：艺术照就是酱紫简单	沙龙学堂	重庆
在木作之中去寻找自己的匠心，木梳、木 勺、手镯DIY制作（三选一）	DIY手作	重庆
左邻右舍 | RPG真人推理游戏：死穿白	派对聚会	重庆
百鬼奇谭|桃花源的那些事儿	派对聚会	重庆
CityWalk跟我一起走|寻找逝去的老重庆-山城第三步道	户外活动	重庆
学尤克里里弹唱草蜢――《失恋阵线联盟》	讲座沙龙	重庆
一杯红酒+ 一部电影，与你话人生 | 本期好片《海底总动员2》	文艺生活	重庆
深深手作情之瓷杯	DIY手作	重庆
烘焙课程丨Forêt-Noire法式黑森林	DIY手作	重庆
CityWalk跟我一起走|寻找逝去的老重庆-百年沧桑南滨路	户外活动	重庆
CityWalk跟我一起走|寻找逝去的老重庆-鹅岭.李子坝	户外活动	重庆
陶艺DIY萌物水杯套装	户外活动	重庆
甜蜜烘焙之美味椰丝球DIY	文艺生活	重庆
绘春，和插画艺术来场约会	讲座沙龙	重庆
手工DIY创意设计生活	DIY手作	重庆
我和僵尸有个约会 | 情人节玩僵尸游戏赢电影票	派对聚会	重庆
品茗论道读书会	派对聚会	重庆
左邻右舍 | 烧脑游戏：饥饿游戏	派对聚会	重庆
左邻右舍油画教室 | 色彩搭配（含零基础）	讲座沙龙	重庆
秀亲情 忆童年 轻质粘土齐动手！	DIY手作	重庆
因语言而相聚：周二英语角（十二月）	派对聚会	重庆
【左邻右舍】左右油画教室 | 软装配画 （含零基础）	派对聚会	重庆
追寻即将消失的传统手工艺――乱针绣	DIY	重庆
我们只为少数人提供单独的吃茶空间	派对聚会	重庆
因语言而相聚：周二一起英语角（十一月）	派对聚会	重庆
做个杯子萌翻自己：萌杯子+萌勺子”一套手作	派对聚会	重庆
体验亲手做咖啡	派对聚会	重庆
NINE TWO万圣一起鬼”混音乐趴	派对聚会	重庆
「新换霓裳月色裙」手工扎染一条飘逸的连衣裙	派对聚会	重庆
每周五晚：一部电影+几个伙伴	电影	重庆
心理学沙龙 | 和心理师一起看「扪心问诊」	派对聚会	重庆
遇见更美的自己，教你画出美美妆容	讲座沙龙	重庆
泥在手心，变成了想要的样子・对粗陶茶碗”	DIY手作	重庆
让你轻松学会一门乐器！~重庆九二UKULELE公开课	暂不开放	重庆
「超实惠」30元3节瑜伽课，三伏天的脱胎换骨	运动健身	重庆
浓情七夕：和TA一起拉坯，做情侣杯子吧~	派对聚会	重庆
花式秀恩爱 之 「做一对爱心木戒」 (黄桷坪专场)	体验课	重庆
学看面相和手相，你也能做个半仙”咯	派对聚会	重庆
八月开启 | RPG真人推理游戏「死穿白」 ，一生只能玩一次的游戏	派对聚会	重庆
「七夕」做个手工包送给Ta吧~	派对聚会	重庆
让人留恋的浓香甜滋味，做一个千层「榴莲」蛋糕	DIY手作	重庆
完成一幅自己喜欢的油画作品，送给自己吧	派对聚会	重庆
杯子杯子，一辈子，来做一个杯子吧~	派对聚会	重庆
遇见更美的自己 | 让形象设计师威廉告诉你发型的重要性！	派对聚会	重庆
「5折优惠」留住永恒之美 ・ 时光封印机制作	文艺生活	重庆
塔罗占星已开启，来解开命运之谜吧~	派对聚会	重庆
香甜华夫饼，我来教你做~	DIY手作	重庆
这不仅仅是知识，「CoRT思维训练分享会」第15期――剔除错误和合并	派对聚会	重庆
神秘学主题沙龙，说说你的神秘体验	派对聚会	重庆
因语言而相聚：周二英语角	派对聚会	重庆
买了相机不会用？专业摄影师教你拍出好照片！	派对聚会	重庆
和TA一起，只看最想看的电影 ・ 自然卷私人影院（南坪协信店）	电影	重庆
和TA一起，只看最想看的电影 ・ 自然卷私人影院（江北九街店）	电影	重庆
爱的课程占卜灵疗	派对聚会	重庆
夏威夷小吉他尤克里里0基础公开课	暂不开放	重庆
指尖上的盛夏果实，带一个绝美花艺饰品出门去~	派对聚会	重庆
第12期 ・ CoRT思维训练分享会，不止是知识	派对聚会	重庆
塔罗占卜	派对聚会	重庆
「形象设计课程」等你来变美~	派对聚会	重庆
和歪果仁聊天是件愉悦的事儿 ・ 听来自美国的Allison家分享他们的生活（自带英语听说技能）	派对聚会	重庆
「遇见一场心动」，单身男女派对又来啦~	派对聚会	重庆
美味可口蔓越莓饼干，自己做~	DIY手作	重庆
零基础体验 | 跟YEE一起学油画	派对聚会	重庆
神秘学主题沙龙	派对聚会	重庆
不止于知识，CoRT思维训练分享会	派对聚会	重庆
跟着Peipei老师，玩转英语口语「看完速7来学点汽车英语」	派对聚会	重庆
虽然有点费脑但去了就省脑的「记忆力培训」	派对聚会	重庆
旧衣物大改造，拯救失宠单品~~~	派对聚会	重庆
（包车包吃喝包玩）300元澳门纯玩一日游	户外活动	珠海
		
		
		
